Dd, Dd, Hhd, Dd, Rd, Rd, Rd, Dd, Rd, Dd, Dd, Dd, Rd, Dd, Rd, Dd, Dd, Dd, Dd, Dd, Dd, Dd, Dd, Dd, Dd, Dd, Dd, Dd, Dd, Dd, Dd, Dd, Dd, Dd, Dd, Dd, Dd, Dd, Dd, Dd, Dd, Dd, Dd, Rd, Dd, Dd, Dd, Dd, Rd, Dd, Dd, Dd, Dd, Rd
Hhd, Hhd, Md, Hhd, Ce, Re^Vct, Hhd, Gd, Gd, Rd, Rd, Rd, Hhd, Hhd, Hhd, Rd, Dd, Dd, Dd, Dd, Dd^Edpp, Dd, Dd, Dd, Dd, Dd^Edpp, Dd, Dd, Dd, Dd, Dd, Dd, Dd, Dd, Dd, Dd, Dd, Rd, Dd, Dd, Rd, Rd, Gd, Gd, Ce, Rd, Dd^Ftd, Ce, Re^Vct, Gd, Rd, Gd, Gd, Dd
Hhd, Md, Md, Ce, 6 Ket, Ce, Md, Hhd, Gs, Gs, Gd, Rd, Hhd, Md, Hhd, Rd, Dd, Dd, Dd, Dd, Dd, Dd, Dd, Dd, Dd, Dd^Edpp, Dd, Dd^Edpp, Dd, Dd^Edpp, Dd^Edpp, Dd, Dd, Dd, Dd, Dd^Edp, Dd, Dd, Dd, Dd, Rd, Gd, Gs, Rd, Re^Vct, Ce, Rd, Ce, 5 Ket, Ce, Ce, Rd, Re^Vct, Dd
Hhd, Md, Md, Md, Ce, Hhd, Md, Ce, Gs^Ftp, Gs, Hhd, Hhd, Hhd, Hhd, Rd, Dd, Dd, Dd, Dd, Dd, Dd, Dd, Dd, Dd, Dd, Dd, Dd, Dd, Dd, Dd^Edpp, Dd, Dd, Dd, Dd, Dd, Dd, Dd, Rd, Rd, Dd, Dd^Ftd, Rd, Gd, Gs^Ft, Gs, Gs^Ft, Gs^Ft, Ce, Gd^Fts, Rd, Gd^Fts, Rd, Gd, Dd
Dd, Hhd, Re, Ce, Re^Vct, Ce, Hhd, Gd^Fts, Wwt, Wwt, Md, Md, Md, Hhd, Hhd, Dd, Dd, Dd^Edp, Dd, Dd, Dd, Dd, Dd, Dd, Hhd, Dd, Dd, Dd, Hhd, Dd, Dd, Dd, Dd, Dd, Dd, Dd, Dd, Dd, Rd, Dd, Gd, Gd^Fts, Rd, Gd, Wwt, Wwt, Wwt, Re^Vct, Rd, Rd, Gd^Fts, Rd, Rd, Dd
Rd, Ce, Hhd, Ce, Re, Hhd, Md, Re^Vct, Wwt, Gs^Ftp, Hhd, Md, Md, Md, Hhd, Dd, Rd, Dd, Rd, Rd, Rd, Rd, Rd, Hhd, Md, Hhd, Dd, Cdr, Md, Hhd, Hhd, Dd, Rd, Rd, Rd, Rd, Rd, Rd, Rd, Rd, Dd^Ftd, Gs, Gd, Gs^Ftp, Wwt, Wwt, Gd^Fetd, Gs^Ft, Gd^Fts, Ce, Gd, Rd, Rd, Dd
Rd, Hhd, Md, Re, Hhd, Hhd, Hhd, Gs^Ftp, Re^Vct, Wwt, Re^Vct, Hhd, Hhd, Hhd, Rd, Rd, Rd, Dd, Rd, Rd, Dd, Rd, Hhd, Rd, Wwf, Qxe, Dd, Hhd, Qxe, Md, Hhd, Rd, Dd, Rd, Dd, Rd, Dd, Rd, Dd, Rd, Rd, Dd^Ftd, Gd, Gs^Ftp, Gs^Ftp, Wwt, Re^Vct, Rd, Gd, Gd^Fts, Gd^Fts, Gd, Gd, Dd
Dd, Hhd, Rd, Re, Md, Md, Hhd, Md, Md, Hhd, Hhd, Hhd, Hhd, Rd, Dd, Rd, Rd, Rd, Dd, Dd, Dd, Hhd, Md, Cdr, Wwf, Dd, Dd^Do, Wwf, Rd, Rd, Rd, Dd, Dd, Dd, Rd, Rd, Dd^Edp, Dd, Dd, Dd, Dd, Rd, Rd, Gd^Fts, Gd, Gs^Ftp, Gd, Gs^Ft, Gd, Gd, Gd, Rd, Rd, Dd
Dd, Rd, Hd, Hhd, Hhd, Hhd, Dd, Hhd, Hhd, Hhd, Hhd, Md, Hhd, Rd, Dd, Dd, Dd, Dd, Dd, Dd, Dd, Hhd, Hhd, Qxe, Rd, Wwf, Rd, Wwf, Qxe, Cdr, Rd, Dd, Dd^Edpp, Dd, Rd, Dd, Dd, Dd, Rd, Rd, Rd, Rd, Dd, Gd^Fts, Rd, Gs, Gd, Gs, Rd, Gs, Rd, Rd, Dd, Dd
Dd, Rd, Rd, Hd, Rd, Rd, Rd, Rd, Dd, Rd, Dd, Hhd, Rd, Dd, Dd, Dd, Dd, Dd, Dd^Edp, Dd, Dd, Dd, Dd, Rd, Hhd, Qxe, Rd, Rd, Dd^Dr, Hhd, Rd, Dd, Dd, Dd, Dd, Rd, Dd, Dd, Rd, Rd, Dd, Dd, Dd, Dd, Dd, Gd^Fts, Rd, Rd, Rd, Rd, Dd, Dd, Rd, Dd
Dd, Dd, Dd^Edpp, Rd, Rd, Dd, Dd, Rd, Rd, Rd, Dd, Dd, Dd, Dd, Ds, Dd^Edpp, Hd, Dd, Dd, Dd, Dd, Dd, Dd, Rd, Hhd, Dd, Rd, Rd, Dd, Dd, Rd, Dd, Dd, Dd, Hd, Rd, Dd^Es, Rd, Dd, Dd, Dd, Dd, Dd^Edp, Dd, Rd, Rd, Dd, Dd, Dd, Rd, Dd, Dd^Edp, Dd, Dd
Dd, Dd, Dd^Edpp, Dd, Dd, Rd, Dd, Rd, Dd, Dd, Dd, Dd^Edp, Ds, Ds, Dd^Edpp, Hd, Hd, Dd, Hd, Dd, Dd, Dd, Dd, Rd, Dd, Dd^Dc, Rd, Dd, Dd, Rd, Dd, Dd, Dd, Hd, Dd^Edpp, Dd, Rd, Rd, Hd, Hd, Hd, Dd, Rd, Rd, Dd, Dd, Dd^Edpp, Dd, Rd, Rd, Dd, Dd^Edpp, Dd, Dd
Dd, Dd, Dd, Dd, Dd^Edp, Rd, Dd, Rd, Rd, Dd, Dd^Dc, Dd^Edpp, Hd, Dd, Dd, Dd, Hd, Hd, Hd, Dd^Es, Dd, Ds^Edpp, Dd, Rd, Dd, Dd, Rd, Dd, Dd, Rd, Dd, Dd^Es, Hd, Dd^Edpp, Ds, Ds, Rd, Hd, Dd, Dd^Edpp, Rd, Rd, Dd, Dd, Ds, Rd, Hd, Dd, Rd, Rd, Dd, Dd^Edpp, Dd, Dd
Dd, Dd^Edpp, Dd, Dd, Dd, Rd, Rd, Rd, Rd, Rd, Rd, Dd, Dd^Edp, Hd, Hd, Dd, Dd, Hd, Dd, Dd, Dd, Dd, Dd, Rd, Dd, Rd, Dd, Dd, Rd, Rd, Dd, Hd, Hd, Dd, Dd, Ds, Rd, Dd, Dd^Edpp, Dd, Rd, Dd, Hd, Hd^Edpp, Dd^Es, Hd, Dd, Rd, Dd, Dd^Es, Dd, Dd, Dd, Dd
Dd, Dd, Dd, Dd, Dd, Dd, Rd, Dd^Es, Rd, Dd, Dd, Rd, Dd, Dd^Do, Dd, Hd, Dd^Edpp, Dd^Edpp, Dd, Hd, Dd, Dd, Dd, Rd, Rd, Rd, Dd, Dd, Rd, Dd, Dd^Edp, Dd, Hd, Hd, Dd, Dd, Rd, Dd^Edpp, Rd, Rd, Hd, Ds, Hd, Dd, Dd, Hd, Rd, Rd, Dd, Dd, Dd, Hd, Dd, Dd
Dd, Dd, Dd, Dd, Ds^Edpp, Dd, Rd, Dd, Dd, Rd, Chr, Rd, Rd, Dd^Dr, Hd, Hd, Dd, Dd, Hd, Dd, Dd, Dd, Rd, Rd, Rd, Rd, Rd, Rd, Dd, Dd, Dd, Dd, Dd^Edp, Dd, Dd, Dd, Rd, Dd, Rd, Dd, Hd, Hd, Hd, Dd, Hd, Rd, Dd, Hd, Dd, Dd, Hd, Dd, Dd, Dd
Dd, Dd, Dd, Dd^Edp, Dd, Dd, Rd, Qxe, Chr, Dd^Dr, Rd, Rd, Dd^Dr, Rd, Rd, Hd, Dd, Dd, Dd, Dd, Rd, Rd, Hhd, Hhd, Gs, Rd, Gs, Rd, Rd, Dd, Dd^Edp, Dd, Dd, Dd, Rd, Rd, Dd, Rd, Rd, Dd, Hd, Hd^Edpp, Dd, Hd, Rd, Rd, Dd, Dd, Dd, Dd, Hd^Edpp, Dd, Dd, Dd
Dd, Dd, Dd, Dd, Dd, Dd, Dd, Chr, Rd, Dd^Dc, Chr, Rd, Dd, Dd, Rd, Hd, Hd, Hd, Rd, Rd, Gs, Gll, Hhd, Hhd, Hhd, Cdr, Gd, Cdr, Gs, Rd, Rd, Dd, Rd, Rd, Rd, Dd, Dd, Rd, Dd, Hd, Dd, Dd, Rd, Rd, Dd, Dd^Edp, Ds, Hd, Hd, Dd, Dd^Edpp, Dd, Dd, Dd
Dd, Dd, Dd, Dd, Dd, Dd, Dd, Rd, Rd, Dd^Dr, Rd, Rd, Rd, Dd, Rd, Dd, Dd, Dd, Rb, Hhd, Md, Hhd, Cdr, Cdr, Cdr, Gd, Gd, Gd, Gll^Gvs, Cdr, Cdr, Rd, Cdr, Rd, Rd, Dd, Rd, Rd, Dd, Dd, Rd, Rd, Dd^Edpp, Dd, Dd, Dd, Dd, Dd, Hd, Hd, Dd^Edp, Dd, Dd, Dd
Dd, Dd^Edpp, Ds, Ds, Dd, Dd^Es, Dd, Dd, Dd, Rd, Dd^Dr, Dd, Dd^Dr, Rd, Rd, Dd, Cdr, Dd, Rb^Dr, Hhd, Hhd, Hhd, Cdr, Hhd^Vhhr, Gd, Gd, Hhd, Gd, Hhd, Rb^Gvs, Hhd, Hhd, Hhd, Rd, Md, Rd, Dd, Dd, Rd, Rd, Dd, Dd, Dd, Dd, Hd, Dd, Hd, Dd, Hd, Dd, Dd, Dd, Dd, Dd
Dd, Dd, Dd, Dd, Dd, Dd, Dd, Dd, Dd, Dd, Dd, Dd, Dd^Dr, Dd^Dc, Dd^Dr, Rd, Rd, Rd, Rd, Re^Vct, Qxe, Cdr, Wwf, Gs, Gd, Hhd, Md, Md, Md, Wwt, Wwt, Re^Gvs, Hhd, Md, Cdr, Rd, Rd, Rd, Dd, Rd, Dd, Ds, Ds, Dd, Dd, Dd, Dd, Hd, Dd, Hd, Dd, Hd, Hd, Dd
Dd, Dd, Dd^Edpp, Dd, Dd, Dd, Dd, Dd^Edpp, Dd, Dd, Dd, Dd, Dd, Dd^Dr, Qxe, Rd, Dd^Dc, Hd, Hd, Re^Dr, Cdr, Wwf, Dd^Dr, Gd, Wwt, Wwt, Md, Md, Md, Gll^Gvs, Wwt, Re^Gvs, Hhd, Md, Rd, Rd, Rd, Dd, Dd, Dd, Dd, Dd^Edpp, Dd, Hd, Hd, Dd, Ds, Dd, Dd, Dd, Dd, Hd, Dd, Dd
Dd, Dd, Dd, Dd, Dd, Ds^Edpp, Dd, Dd, Dd, Dd, Dd, Dd, Dd, Qxe, Cdr^Dr, Qxe, Hd, Hd^Dr, Dd, Ce, Qxe, Qxe, Qxe, Dd^Dr, Wwt, Gs, Gd, Md, Hhd^Vc, Hhd, Wwt, Re^Gvs, Hhd, Rd, Hhd, Hhd, Hhd, Rd, Rd, Dd, Dd, Hd^Edpp, Hd, Hd, Dd, Hd, Dd, Ds, Dd, Hd, Dd, Hd, Dd, Dd
Dd, Dd, Dd, Dd^Es, Dd, Dd, Dd, Dd, Dd, Dd, Dd, Dd, Cdr, Cdr, 3 Kdr, Dd^Edp, Dd, Cdr, Ce, Dd, Re, Dd^Dr, Hd, Qxe, Wwt, Wwt, Wwt^Bw|r, Wwt, Wwt, Wwt, Gd, Wwt, Wwt, Hhd, Md, Md, Md, Hhd, Rd, Dd, Dd, Hd, Hd, Dd, Hd, Dd, Dd, Dd, Dd, Dd, Hd, Dd, Dd, Dd
Dd, Dd, Dd, Dd, Dd, Dd, Ds, Dd, Dd, Dd, Dd, Dd, Dd^Dr, Cdr, Dd^Vdt, Ce^Dr, Cdr, Cdr, Qxe, Dd^Es, Rd, Re, Re, Gd^Fts, Wwt, Gd, Gd, Gs^Efm, Gd^Fts, Wwt, Wwt, Gs, Wwt, Hhd, Hhd, Md, Hhd, Hhd, Rd, Dd, Dd, Dd, Dd, Dd, Dd, Dd, Ds, Hd, Dd, Hd, Dd, Dd, Dd, Dd
Dd, Dd, Dd, Ds, Dd^Edpp, Dd, Dd, Dd, Dd, Ds, Dd, Dd, Rd, Cdr, Re, Dd^Dr, Dd^Dr, Dd^Vda, Rd, Rd, Qxe, Gd, Gs, Rp, Cdr, Rp, Rp, Cdr, Cdr, Gd, Wwt, Gd, Gd, Wwt, Wwt, Hhd, Rd, Rd, Dd, Dd, Dd, Dd, Dd^Edpp, Dd, Ds, Hd, Dd, Ds, Dd, Dd, Dd, Dd, Dd, Dd
Dd, Dd, Dd, Ds, Dd, Dd^Es, Dd, Dd, Dd, Dd, Ds, Dd, Rd, Dd, Dd, Dd, Hd, Rd, Wwt, Wwt, Rp, Gd, Rp, Rp, Gd, Cdr, 2 Kdr, Cdr, Cdr, Gs, Wwt, Gs^Vc, Gd, Gs, Gd, Hhd, Gd^Vhr, Rd, Rd, Dd, Dd, Dd, Dd, Dd, Dd, Hd, Ds, Dd, Dd, Dd^Es, Dd, Dd, Dd, Dd
Dd, Dd, Dd, Ds, Dd, Dd, Dd^Edpp, Dd, Dd, Dd, Dd, Dd, Rd, Dd, Dd, Dd^Dc, Cdr, Rd, Wwf, Rp, Gd^Fts, Rp, Cdr, Rp, Cdr, Cdr, Cdr, Rp, Rp, Rp, Wwf, Wwt, Gd, Gd, Gs^Ftp, Gs^Ftp, Hhd, Hhd, Hhd, Rd, Rd, Dd, Dd, Dd, Dd, Dd, Dd, Dd, Dd, Dd, Dd, Dd, Dd, Dd
Dd, Dd, Dd^Es, Dd, Dd, Dd, Dd^Edpp, Dd, Dd, Dd, Rd, Rd, Dd, Dd, Dd, Dd, Wwt, Wwf, Wwf, Rd^Vc, Gd, Gs^Efm, Gd, Cdr, Gs^Efm, Gd^Fts, Cdr, Rp, Cdr, Wwf, Rd, Cdr, 4 Kdr, Gs^Ftp, Gs^Ftp, Hhd, Md, Md, Md, Hhd, Rd, Dd, Dd, Dd^Edpp, Dd, Dd, Dd^Es, Ds, Dd, Dd, Dd, Dd, Dd, Dd
Dd, Dd, Dd, Dd, Dd, Dd^Edpp, Dd, Dd^Edpp, Dd, Dd, Rd, Ds, Dd, Dd, Wwt, Wwt, Cdr, Rd, Re^Vct, Rd, Rd, Rd, Rd, Rd, Gs, Rd, Rd, Rd, Wwf, Wwf, Gd^Fts, Rd, Rd, Cdr, Gs^Ftp, Hhd, Hhd, Md, Hhd, Hhd, Rd, Dd, Dd, Dd, Dd, Dd^Edpp, Dd, Dd, Dd^Edpp, Ds^Edpp, Dd, Dd, Dd, Dd
Dd, Dd, Dd, Dd, Dd, Dd, Dd^Edpp, Dd^Edpp, Dd, Dd, Rd, Dd, Dd, Dd, Dd, Dd, Rd, Cdr, Cdr, Cer, 1 Kdr, Rd, Rd, Rd, Dd, Rd, Rd, Wwt, Wwt, Gd^Fts, Gd^Fts, Cdr, Cer, Cdr, Hhd, Re^Vct, Rd, Hhd, Cdr, Rd, Dd, Dd, Dd, Dd, Dd^Edpp, Dd, Dd, Dd, Dd, Dd, Dd, Dd, Dd, Dd
Dd, Dd, Dd, Dd^Edpp, Dd, Dd, Dd, Dd, Dd^Edpp, Dd^Edpp, Dd, Rd, Dd, Dd, Rd, Rd, Rd, Rd, Rd, Rd, Cdr^Dr, Wwf, Wwt, Dd, Gd^Fts, Dd, Rd, Gd^Fts, Wwt, Cdr, Gs^Vc, Hhd, Cdr, Rd, Rd, Rd, Gd^Fts, Rd, Rd, Rd, Dd, Dd, Dd, Dd^Edp, Dd, Dd, Dd, Dd, Dd, Dd, Dd, Dd, Dd, Dd
Dd, Dd, Dd, Dd, Dd, Dd^Edp, Ds, Dd, Dd^Edpp, Dd, Dd, Rd, Rd, Dd, Rd, Hd, Rd, Rd, Rd, Qxe, Dd, Cdr, Wwt, Dd^Vdt, Dd^Dc, Rd, Rd, Cdr, Wwt, Wwt, Gd, Gd, Re^Gvs, Gs, Hhd, Gs^Ftp, Cdr, Rd, Rd, Rd, Rd, Dd, Rd, Dd, Rd, Dd, Dd, Dd^Esd, Dd, Dd, Dd, Dd, Dd, Dd
Dd, Dd, Dd, Dd, Dd, Ds, Dd, Dd, Dd, Dd, Rd, Rd, Rd, Rd, Dd^Dr, Rd, Rd, Hd, Hd, Dd, Qxe, Dd, Wwt, Cdr, Rd^Dr, Gd^Fts, Cdr, Wwt, Rb, Re, Cdr, Gd, Re^Gvs, Re^Gvs, Gd, Gd^Fts, Rd, Rd, Dd^Dr, Rd, Rd, Rd, Rd, Rd, Rd, Hd, Dd, Dd^Edpp, Dd, Dd^Edpp, Dd, Dd, Dd, Dd
Dd, Dd^Edpp, Dd^Edpp, Dd, Dd, Ds, Dd, Dd, Dd^Es, Dd^Dr, Rd, Rd, Dd, Dd^Dr, Dd, Dd, Rd, Dd, Hd, Wwt, Wwt, Wwt, Dd, Wwt, Wwt, Dd^Vda, Cdr, Wwt, Rd^Dr, Kdr, Gll^Dr, Hhd, Gd^Fts, Hhd, Gd, Gd, Rd, Dd, Dd, Dd, Dd, Dd, Dd, Rd, Rd, Dd, Dd^Dr, Dd, Dd, Dd, Dd, Dd, Dd, Dd
Dd, Dd, Dd, Dd, Dd^Edpp, Dd, Dd, Dd, Dd, Rd, Rd, Dd, Dd^Edpp, Dd, Dd^Edpp, Dd, Rd, Rd, Dd, Dd, Hd, Hd, Dd, Wwt, Gd^Fts, Wwt, Wwt, Wwt, Cdr, Cdr, Gd^Fts, Gd^Fts, Hhd, Hhd, Rd, Rd, Dd, Dd, Dd, Dd, Dd, Dd, Dd, Hd, Dd^Dr, Rd, Rd, Hd, Dd, Dd, Dd, Dd^Edp, Dd, Dd
Dd, Dd, Dd^Edp, Dd, Dd, Dd^Edpp, Dd, Dd, Rd, Rd, Rd, Dd, Ds, Ds^Edpp, Ds, Dd, Dd, Rd, Dd, Dd, Dd, Hd, Dd, Wwt, Gd^Fts, Rd, Wwt, Re, Re, Re, Re, Re, Rd, Rd, Dd, Rd, Rd, Dd, Dd, Dd^Edpp, Dd, Hd, Dd, Dd, Dd, Rd, Dd, Rd, Dd, Dd, Dd, Dd, Dd, Dd
Dd, Dd, Dd, Dd, Dd, Dd, Dd, Dd, Dd, Dd, Rd, Dd, Dd, Dd^Edpp, Dd, Ds, Dd, Rd, Dd, Dd, Dd, Dd, Dd, Wwt, Dd, Dd, Wwt, Dd, Dd, Rd, Dd, Rd, Dd, Rd, Rd, Dd, Rd, Dd^Edpp, Dd, Dd, Dd, Dd, Dd, Hd, Rd, Rd, Dd^Dr, Rd, Rd, Dd, Dd, Dd, Dd, Dd
Dd, Dd, Dd, Dd, Dd, Hd, Hhd, Hd, Hd, Dd, Rd, Dd, Wwg, Dd^Do, Dd^Edp, Dd, Rd, Rd, Dd, Ds, Ds, Dd, Dd, Dd, Dd, Dd, Wwt, Dd, Dd, Rd, Dd, Dd, Ds, Dd, Dd, Rd, Dd, Dd, Gd, Dd, Dd, Dd, Dd, Dd, Rd, Rd, Dd, Dd, Rd^Eff, Hd, Rd^Eff, Dd, Dd, Dd
Dd, Dd, Dd^Edpp, Dd^Es, Dd, Hd, Hhd, Md, Hhd, Rd, Hhd, Hhd, Md, Wwg, Hhd, Rd, Dd, Dd, Dd, Dd, Dd, Dd, Dd^Edpp, Dd, Dd, Dd, Dd^Dc, Wwt, Dd, Dd, Dd, Dd, Ds^Edpp, Ds, Dd, Rd, Rd, Gd, Gs^Ftp, Rd, Dd, Hd, Dd, Dd, Dd, Rd, Hd, Hd, Dd, Dd^Vdt, Dd, Dd^Eff, Dd, Dd
Dd, Dd, Dd, Dd, Dd, Hd, Dd, Hhd, Dd, Rd, Hhd, Md, Md, Md, Hhd, Dd, Dd, Dd, Dd, Hd, Dd, Dd, Dd^Edpp, Dd, Dd^Edpp, Dd^Dr, Wwt, Wwt, Dd, Dd, Dd^Edpp, Dd, Dd, Dd, Dd, Dd, Gd, Gs^Ftp, Dd^Do, Gd, Dd, Rd, Dd, Dd^Edp, Dd, Rd, Rd, Hd, Hd, Rd, Dd^Eff, Hd, Dd, Dd
Dd, Dd, Dd, Dd, Dd, Hd, Dd, Hd, Dd, Dd, Dd, Hhd, Rd, Dd^Edp, Dd, Dd, Hd^Edpp, Ds, Dd, Hd, Dd^Esd, Hd^Edpp, Dd, Dd, Dd, Dd, Wwt, Dd, Dd, Dd^Edpp, Dd, Ds^Edpp, Dd, Dd, Dd, Hd, Dd, Rd, Gd, Rd, Dd, Dd, Dd, Dd, Rd, Rd, Rd, Dd, Dd, Rd, Dd, Dd, Dd, Dd
Dd, Dd, Dd, Dd, Dd, Hd, Dd, Dd, Hd, Rd, Dd^Edpp, Dd, Rd, Dd, Dd, Hd, Hd, Dd^Edpp, Dd, Hd, Dd^Edpp, Dd, Dd, Dd, Dd, Wwt, Wwt, Dd^Dr, Dd, Dd, Dd, Dd^Edpp, Dd^Edpp, Dd, Dd, Rd, Dd, Dd, Rd, Hd, Dd, Dd, Dd, Dd, Dd, Rd, Rd, Dd, Rd, Rd, Dd, Dd, Dd, Dd
Dd, Dd, Dd, Hd, Dd, Dd, Dd^Edpp, Dd, Dd, Dd, Dd, Dd, Rd, Dd, Hd, Dd^Edpp, Dd, Ds^Edpp, Hd, Dd^Edpp, Hd, Hd, Hd, Dd, Wwg, Dd^Dr, Wwt, Wwt, Wwt, Dd, Dd, Dd, Dd, Dd^Edpp, Dd, Dd, Dd, Dd, Dd, Rd, Dd, Dd, Dd, Dd, Ce, Dd, Dd, Rd, Rd, Dd^Edp, Dd, Dd, Dd, Dd
Dd, Dd, Dd, Dd, Dd, Dd, Dd, Hd, Dd, Rd, Rd, Rd, Dd, Dd, Hd, Dd, Dd, Ds, Hd, Dd, Dd, Dd, Hd, Dd, Wwg, Dd, Wwt, Wwt, Dd^Ftd, Dd, Wwg, Dd, Dd, Dd, Dd, Dd, Dd, Dd^Edpp, Rd, Rd, Dd, Dd^Edp, Dd, Dd, Rd, Dd, Dd^Ftd, Dd, Rd, Dd, Rd, Ce, Dd, Dd
Dd, Hd, Dd^Ftd, Hd, Dd, Dd^Ftd, Dd, Hd, Hd, Dd^Ftd, Dd, Rd, Hd, Dd, Dd, Hd, Dd, Hd, Dd, Dd, Dd, Dd, Rd, Md, Hd, Dd, Wwt, Wwt, Hd, Dd, Dd^Ftd, Dd, Dd, Dd^Dr, Dd, Rd, Dd, Dd, Rd, Dd, Hd, Dd, Dd^Dr, Dd, Gd, Rd, Gd^Vhr, Rd, Gd, Hhd, Hhd, Dd, Dd, Dd
Dd, Dd, Dd, Hd, Cdr, Hd, Hd, Dd^Ftd, Wwf, Hd, Dd^Ftd, Rd, Hd, Dd, Dd^Ftd, Hd, Hd, Hd^Edpp, Dd^Edpp, Dd, Rd, Rd, Dd, Rd, Md, Hd, Wwt, Dd^Vdt, Md, Dd, Dd, Rd, Rd, Dd, Rd, Rd, Rd, Rd, Rd, Rd, Rd, Dd, Rd, Rd, Hhd, Hhd, Hhd, Rd, Gd^Dr, Rd, Gd, Dd^Vdt, Dd^Ftd, Dd
Dd, Dd^Ftd, Wwf, Hd, Dd^Ftd, Hd, Dd^Ftd, Dd^Vdt, Hd, Dd, Hd, Rd, Rd, Rd, Rd, Rd, Rd, Dd, Dd, Dd, Rd, Dd, Dd, Md, Dd, Wwt, Wwt, Hd, Dd, Wwt, Dd, Dd, Dd, Rd, Rd, Rd, Dd, Dd, Dd, Dd, Ce, Rd, Gd, Gd, Hhd, Md, Md, Hhd, Hhd, Rd, Rd, Rd, Dd^Vdt, Dd
Dd, Dd, Dd^Ftd, Hd, Dd^Vdt, Wwt, Wwt, Hd, Dd^Ftd, Cdr, Dd^Vdt, Wwf, Hd, Dd^Ftd, Dd, Hd, Dd, Rd, Rd, Rd, Dd, Dd, Dd, Hd, Dd, Wwt, Dd, Dd, Dd, Wwt, Dd, Dd, Dd^Ftd, Dd, Dd, Dd, Dd, Dd^Edp, Dd, Dd, Rd, Hhd, Rd, Dd^Ftd, Hhd, Md, Mv, Md, Hhd, Ce, Dd^Ftd, Ce, Rd, Dd
Dd, Dd, Cdr, Hd, Cdr, Wwt, Cdr, Cdr, Hd, Hd, Dd^Ftd, Dd, Hd, Hd, Dd, Hd, Dd, Dd, Dd, Rd, Dd, Dd, Dd, Dd, Dd, Wwt, Dd^Ftd, Dd, Dd, Wwt, Dd, Rd, Dd, Hd, Dd, Dd, Dd, Hd, Dd, Dd^Dc, Rd, Gd, Rd, Gd^Vhr, Hhd, Mm, Mm, Mm, Hhd, Ce, 7 Ket, Rd, Gd, Dd
Hd, Dd^Ftd, Dd^Vdt, Cdr, Hd, 8 Kdr, Wwf, Cdr, Hd, Dd^Vdt, Dd, Dd, Dd, Dd, Hd, Dd, Dd, Dd, Dd, Dd, Dd^Ftd, Hd, Hd, Dd^Esd, Dd, Wwt, Dd, Hd, Wwt, Wwt, Dd, Dd, Dd, Hd, Dd^Ftd, Dd, Dd, Dd, Dd, Dd, Hhd, Gd, Dd^Ftd, Gd, Rd, Hhd, Hhd, Hhd, Gd, Ce, Hhd, Ce, Hhd, Dd
Dd, Dd, Dd, Dd, Dd^Ftd, Dd^Vdt, Hd, Hd, Dd^Ftd, Dd, Cdr, Hd, Dd, Hd, Dd^Ftd, Hd, Dd, Dd, Dd, Dd^Esd, Dd, Rd, Dd, Dd, Dd, Wwt, Wwt, Wwt, Rd, Dd, Dd, Dd, Dd, Dd, Rd, Dd, Dd, Dd^Edp, Dd, Ce, Dd, Dd^Do, Dd^Vdt, Rd, Rd, Gd^Dr, Rd, Gd, Rd, Rd, Ce, Ce, Dd, Dd
Dd, Dd^Ftd, Dd, Dd, Dd, Dd, Dd^Ftd, Dd, Dd, Dd, Hd, Dd^Ftd, Dd, Dd^Ftd, Dd, Hd, Dd, Dd, Dd, Dd, Dd, Dd, Dd, Dd, Dd^Ftd, Dd, Wwt, Dd, Hd, Dd^Ftd, Dd, Dd, Dd, Dd, Dd, Dd, Dd, Dd, Dd, Hhd, Hd, Dd^Edp, Dd, Hhd, Dd, Rd, Dd, Dd^Ftd, Dd^Ftd, Dd, Dd, Dd, Dd, Dd
Dd, Dd, Dd, Dd, Dd, Dd, Dd, Dd, Dd, Dd, Dd, Dd, Dd, Hd, Dd, Dd, Dd, Dd, Dd, Dd, Dd, Dd, Dd, Rd, Dd, Dd, Wwt, Wwt, Dd, Dd, Dd, Dd, Dd, Dd, Dd, Dd, Dd, Dd, Dd, Dd, Dd, Dd, Dd, Hd, Dd, Dd, Dd, Dd, Dd, Dd, Dd, Dd, Dd, Dd
