border_size=1
usage=map

Rr, Rr, Rr, Rr, Rd, Rr, Rr, Rr, Rr, Rr, Rr, Rr, Rr, Rr, Rr, Rr, Rr, Rr, Rr, Rr, Rr, Rr
Rr, Rr, Rr, Dd^Dr, 7 Khr, Rr, Rd, Rr, Rr, Rr, Rd, Rr, Rr, Rr, Dd^Dc, Dd, Rr^Dr, Rr, Khr, Rr, Rr, Rr
Rr, Rr, Rr, Rr, Rr, Rr, Rr, Rr, Rd, Rr, Rr, Rd, Dd, Rr, Rr, Rr, Rr, Rd, Rr, Dd, Rr, Rr
Rr, Rr, Dd, Dd^Dc, Rd, Dd, Rr, Rr, Rr, Dd^Dr, Rr, 2 Khr, Rr, Rr, Rd, Rr, Rr, Rr, Dd, Rr^Dr, Rr, Rr
Rr, Rr, Rr, Rr, Rr, Rr^Dr, Rr, 3 Khr, Rr, Rr, Rr, Rr, Dd, Rr, Rr, 4 Khr, Rr, Rr, Rr, Rr, Dd, Rr
Rr, Dd, Rr, Rd, 5 Khr, Rr, Rr, Rr, Rr, Rr, Rr, Rr, Rr, Rr, Dd^Dc, Rr, Rd, Rr, 6 Khr, Rr, Rr, Rr
Rr, Rr, Rr^Dr, Rr, Rr, Rr, Rr, Dd^Dr, Rr, Rr, Wwg, Wwg, Wwg, Rr, Rr, Dd, Rr, Rr, Dd^Dr, Rr, Rr, Rr
Rr, Rr, Rr, Dd, Dd^Dc, Rr, Rr, Rr, Wwg, Rr, Wwg, Chr, Wwg, Rr^Dr, Wwg, Rr, Rr, Rr, Rr, Rr, Dd, Rr
Rr, Rr, Rr, Rr, Khr, Rr, Rr, Wwg, Chr, Wwg, Wwg, Rr, Wwg, Wwg, Chr, Wwg, Rr, Dd, 8 Khr, Rr, Rr, Rr
Rr, Rr, Dd, Rd, Rd^Dr, Dd, Rr, Wwg, Wwg, Rr, Rr, Rr, Rr, Rr, Wwg, Wwg, Rr, Rr, Dd, Rr, Rr, Rr
Rr, Rr, Rr, Rr, Rr, Rd, Rr, Rr, Rr, Wwg, Rr, 1 Rr, Rr, Wwg, Rr, Rr, Dd, Rr^Dr, Dd^Dc, Rr, Dd, Rr
Rr, Rr, Rr, Dd, Rr, Dd, Rr, Rd, Rr, Wwg, Rr, Rr, Rr, Wwg, Rr, Rr, Rr, Rr, Dd, Rr, Rr, Rr
Rr, Rr, Rr, Rr, Rr, Rr, Rr, Rr, Rr, Wwg, Rr, Rr, Rr, Wwg, Rr, Rr, Rr, Rr, Rr, Rr, Rr, Rr
