border_size=1
usage=map

Dd, Dd, Dd, Hd, Dd, Hd, Hd, Dd, Hd, Hd, Dd, Hd, Dd, Dd, Dd^Ftd, Dd^Ftd, Dd, Dd, Hd, Dd, Dd, Hd, Dd, Dd, Hd, Dd, Dd, Dd, Hd, Dd, Dd, Dd
Hd, Hd, Hd, Hd, Dd, Hd, Hd^Edpp, Hd, Dd, Dd, Dd^Ftd, Dd, Dd, Dd^Ftd, Rd, Rd, Dd, Dd, Dd, Hd, Dd, Dd, Dd, Hd, Dd, Hd, Dd, Dd, Hd, Dd, Dd, Dd
Dd, Dd, Hd, Hd, Hd, Hd, Dd, Dd, Dd, Dd, Rd, Dd^Ftd, Rd, Dd^Vdt, Wwt, Gd, Dd^Ftd, Dd, Dd, Hd, Dd, Hd, Dd, Hd, Hd, Dd, Dd, Hd^Edpp, Dd, Hd, Dd, Hd
Hd, Hd, Hd, Dd^Es, Hd, Dd, Dd, Hd, Dd, Dd^Ftd, Rd, Gd, Gs, Wwt, Ce, Wwt, Gs, Dd^Ftd, Dd, Dd, Dd, Hd, Hd^Edpp, Dd, Dd^Es, Hd, Dd, Hd, Hd^Edpp, Hd, Hd, Dd
Hd, Hd, Hd, Hd, Dd, Dd, Hd, Hd, Dd, Dd^Ftd, Rd, Gs, Wwt, Ce, 1 Ket, Ce, Wwt, Dd^Ftd, Dd, Hd, Dd^Edpp, Hd, Hd, Dd, Hd, Hd, Hd, Hd, Dd^Edpp, Hd, Hd, Hd
Hd, Dd^Edpp, Hd, Hd^Edpp, Dd, Hd, Dd, Hd, Hd, Dd, Dd, Dd^Vdt, Rd, Ce, Ce, Ce, Wwt, Dd^Vdt, Dd, Dd, Dd, Hd, Dd, Hd, Hd, Dd, Hd, Hd, Dd, Dd, Hd, Hd
Hd, Hd, Dd, Hd, Hd, Dd^Edpp, Dd, Dd, Dd, Hd, Dd, Dd^Ftd, Dd^Ftd, Gd, Dd, Wwf, Dd^Ftd, Dd^Ftd, Dd, Dd, Hd, Dd, Hd, Hd, Dd, Hd, Dd, Hd^Edpp, Dd, Dd, Dd, Hd
Dd, Dd, Dd, Dd, Dd, Dd, Hd^Edpp, Hd^Edpp, Hd, Dd, Dd, Dd^Ftd, Dd, Rd, Dd^Ftd, Wwf, Dd^Ftd, Dd^Ftd, Hd, Dd, Hd, Hd, Hd, Dd, Dd, Dd^Edpp, Dd, Dd, Hd, Dd, Hd^Edpp, Dd
Dd, Dd, Dd^Esd, Dd^Es, Dd^Edpp, Dd, Hd, Hd, Dd, Dd, Hd, Dd, Dd, Dd^Ftd, Dd^Ftd, Rd, Rd, Dd, Hd, Hd, Hd, Hd, Dd^Es, Hd, Hd, Dd, Dd, Hd, Dd, Dd, Dd, Dd
Dd^Esd, Dd, Dd, Dd, Dd, Dd, Dd, Dd, Dd, Hd, Dd^Edpp, Dd, Dd, Dd, Rd, Dd, Rd, Dd, Hd, Hd, Hd, Dd, Dd, Hd, Hd, Dd, Dd, Hd, Dd, Dd, Dd, Hd
Dd, Dd, Dd^Edpp, Dd^Edpp, Dd^Edpp, Dd, Dd, Dd, Dd, Hd^Edpp, Hd, Hd, Hd, Hd, Rd, Rd, Dd, Dd, Hd, Hd, Dd, Hd, Dd, Dd, Hd, Hd, Dd, Dd, Dd, Dd, Dd, Dd
Dd, Dd, Dd, Dd, Dd, Dd^Edpp, Dd, Dd, Dd^Edpp, Hd, Hd, Hd, Dd, Rd, Rd, Dd, Dd, Hd, Dd, Dd, Dd, Dd, Dd, Dd, Dd, Dd, Dd, Dd, Dd^Es, Dd, Dd, Dd
Dd, Dd^Edpp, Dd, Dd, Dd, Dd, Dd, Dd, Dd^Edpp, Dd, Dd, Dd, Dd, Dd, Chr, Rd, Hd, Dd, Dd, Dd, Dd, Dd, Dd, Dd, Dd, Dd, Dd, Dd, Dd, Dd^Esd, Dd, Hd
Dd, Dd, Dd, Dd, Dd, Dd^Edpp, Dd, Dd, Dd^Edpp, Dd, Dd, Rd, Rd, Chr^Dr, Rd, Rd, Chr, Hd, Dd, Dd, Dd^Esd, Dd, Dd, Dd, Dd, Dd, Dd, Dd^Esd, Dd, Dd, Dd, Dd
Dd, Dd, Dd, Dd, Dd, Dd, Dd, Dd, Dd, Dd, Hd, Chr, Chr^Dr, Hhd, Rb, Re, Re, Rd, Rd, Rd^Dr, Dd, Dd, Dd^Edpp, Dd^Es, Dd, Dd, Dd, Dd, Dd, Dd, Dd, Dd
Dd, Dd^Edpp, Dd, Dd^Es, Dd, Dd, Dd, Dd^Edpp, Dd, Dd, Dd^Edpp, Hd, Chr, Rd, Re, Rp^Vhcr, Rb, Hhd, Rd, Dd, Hd, Dd, Dd, Dd, Dd, Dd, Dd, Dd^Edp, Dd, Dd, Dd, Dd
Dd, Dd^Edpp, Dd, Dd, Dd, Dd, Dd^Esd, Dd^Esd, Dd, Dd, Dd, Hd, Hhd, Hhd, Rd, Re, Chr, Chr^Dr, Chr^Dr, Chr, Dd, Dd, Dd, Dd, Dd^Edpp, Dd, Dd, Dd, Dd, Dd, Dd^Edp, Dd
Dd, Dd, Dd, Dd^Edpp, Dd, Dd, Dd^Es, Dd, Dd, Dd, Dd, Dd, Rd, Rd, Dd, Dd, Chr, Hd, Hd, Dd, Dd, Dd, Dd, Dd, Dd, Dd, Dd, Dd, Dd, Dd, Dd, Dd
Dd, Dd, Dd, Dd, Dd, Dd^Edpp, Dd^Edpp, Dd, Dd, Dd, Dd, Rd, Dd, Chr, Chr^Dr, Rd, Dd, Dd, Dd, Dd, Dd, Dd^Esd, Dd, Dd^Esd, Dd, Dd, Dd, Dd, Dd, Dd, Dd, Dd
Dd, Dd, Dd, Dd^Es, Dd, Dd, Dd, Dd, Dd, Dd, Dd, Dd, Dd, Hd, Dd, Rd, Dd, Dd, Dd, Dd, Dd, Dd, Dd, Dd, Dd, Dd, Dd, Dd, Dd, Dd, Dd, Dd
Dd, Dd, Hd, Dd, Dd, Dd, Hd, Dd^Esd, Dd, Dd, Dd, Rd, Dd, Dd, Rd, Rd, Rd, Dd, Dd, Dd^Es, Dd, Dd, Dd^Edp, Dd, Dd, Dd, Dd, Dd^Edp, Dd, Dd, Dd, Dd
Hd, Hd, Dd, Dd, Dd^Esd, Dd, Hd, Dd, Dd, Dd^Edpp, Dd, Rd, Dd, Dd, Rd, Rd, Rd, Dd, Dd, Dd, Dd, Dd, Dd, Dd, Dd, Dd, Dd, Dd, Dd, Dd, Dd, Dd
Hhd, Hd, Md, Hd, Hd, Dd, Hd, Hd, Dd, Dd, Dd, Rd, Dd, Dd, Rd, Rd, Dd, Rd, Dd, Dd, Hd, Dd, Dd, Dd, Dd^Edp, Dd, Dd, Dd, Dd, Dd, Dd, Dd
Hhd, Hhd, Md, Dd, Hd, Hd, Dd, Dd, Dd, Dd^Edpp, Dd, Rd, Rd, Dd, Rd, Rd, Dd, Rd, Hhd, Hd, Hd, Dd, Dd^Dr, Dd, Hhd, Dd, Dd, Dd, Dd, Dd, Dd, Dd
Md, Hhd, Hhd, Md, Dd, Hd, Dd, Dd, Dd^Edpp, Dd^Edpp, Dd, Dd, Dd, Rd, Rd, Dd, Dd, Rd, Rd, Dd^Dr, Hhd, Hhd, Dd, Dd, Hhd, Hd, Hhd, Dd, Dd, Dd^Edp, Dd, Dd
Hhd, Hhd, Md, Md, Hd, Hd, Dd, Dd^Edpp, Dd, Dd, Dd, Dd, Hd, Rd, Dd, Rd, Dd, Rd, Rd, Dd, Rd, Rd, Khr, Rd, Rd, Dd, Rd^Dr, Dd, Dd, Dd, Dd, Dd
Md, Md, Dd, Hd, Dd, Dd, Dd, Dd, Dd, Dd, Hd, Dd^Do, Hd, Rd, Dd, Dd, Dd, Dd, Rd, Rd, Chr, Rp^Vhcr, Chr, Chr, Chr, Dd, Hd, Rd, Rd, Dd, Dd, Dd
Md, Dd, Dd, Hd, Hd, Dd, Dd, Dd, Dd, Dd, Hd, Hd, Dd, Rd, Dd, Dd, Dd, Rd, Hhd, Rd, Rd, Chr, Re, Rp^Vhcr, Chr, Hd, Dd^Dr, Dd, Dd, Rd, Rd, Dd
Dd, Md, Md, Dd, Dd, Hd, Dd, Dd, Dd, Dd, Dd, Dd, Rd, Rd, Dd, Dd, Rd, Hhd, Hd, Dd^Dr, Dd, Rd, Rd, Chr, Rd, Hhd, Dd, Rd, Rd, Dd, Rd, Dd
Dd, Hhd, Md, Dd, Dd^Edpp, Dd, Dd, Dd^Es, Dd, Dd, Dd, Dd, Rd, Dd, Dd, Rd, Dd, Dd, Dd, Dd, Hd, Hd, Hhd, Rd, Dd, Rd, Rd, Rd, Rd, Rd, Rd, Rd
Md, Hhd, Dd, Dd, Dd, Dd, Dd, Dd, Dd, Dd, Dd, Dd, Dd, Rd, Rd, Dd, Rd, Dd, Rd, Dd, Dd, Hd, Hhd, Hd, Rd, Rd, Dd, Dd, Dd, Dd, Dd, Dd
Hhd, Dd, Dd, Dd, Dd, Dd^Edpp, Dd, Dd, Dd^Edpp, Dd, Dd, Dd, Dd, Dd, Rd, Dd, Hd, Hd, Hd, Dd, Rd, Rd, Rd, Rd, Dd, Dd, Dd, Dd, Dd, Dd, Dd, Dd
Hd, Hd, Dd, Dd, Dd^Edpp, Dd, Dd, Dd, Dd, Dd, Hd, Dd, Dd, Dd, Hd, Rd, Dd, Dd, Dd, Dd, Dd, Dd^Esd, Rd, Dd, Rd, Rd, Dd, Dd, Dd, Dd, Dd, Dd
Md, Md, Hd, Dd, Dd, Dd, Dd, Dd, Dd, Dd, Hd, Hd, Dd^Ftd, Hd, Dd^Ftd, Rd, Hhd, Dd^Vdt, Dd^Ftd, Hd, Rd, Rd, Dd^Esd, Dd, Dd, Dd, Rd, Rd, Dd, Dd, Dd, Rd
Hd, Hd, Dd, Hd, Dd, Dd, Dd, Dd, Dd, Dd, Dd, Dd^Ftd, Dd^Ftd, Dd^Ftd, Chr, Chr, Chr, Hhd, Rd, Rd, Rd, Rd, Rd, Rd, Rd, Rd, Dd, Dd, Dd, Dd, Rd, Dd
Dd, Dd, Dd, Dd, Dd, Dd, Dd, Dd, Dd, Dd, Hd, Dd^Ftd, Gd^Fts, Hhd, Gd^Fts, 3 Khr, Rd, Rd, Wwt, Gs, Dd^Ftd, Dd^Ftd, Dd^Ftd, Dd, Dd^Esd, Rd, Dd, Rd, Rd, Rd, Dd, Dd^Edb
Dd, Dd, Dd^Edpp, Hd, Dd, Dd, Dd^Esd, Dd, Dd, Hd, Hd, Hd, Gd^Fts, Dd^Ftd, Rd, Gd, Rd, Wwt, Wwt, Gd, Gd, Rd, Dd^Ftd, Dd, Dd, Dd^Esd, Dd, Dd, Dd, Dd, Dd, Dd
Hd, Dd, Dd, Hd, Dd, Dd, Hd, Dd, Dd, Hd, Dd^Ftd, Gd^Fts, Hd, Hd, Dd^Ftd, Rd, Rd, Wwt, Gd, Gd^Fts, Hd, Rd, Hd, Dd, Dd, Dd, Dd, Dd, Dd, Dd, Dd, Dd
Hd, Dd, Dd, Dd, Dd, Dd, Dd, Dd, Dd, Dd, Dd, Dd^Ftd, Dd, Hd, Hd, Rd, Dd^Ftd, Gs, Gd, Dd^Ftd, Dd, Hd, Dd, Dd, Dd, Dd, Dd, Dd, Dd, Dd, Dd, Dd
Dd, Hd, Hd, Dd, Hd, Dd, Dd, Dd, Dd, Dd, Dd, Dd, Dd, Hd, Rd, Rd, Dd, Dd^Ftd, Dd, Rd, Dd, Dd, Dd, Dd, Dd, Dd, Dd, Dd, Dd, Dd, Dd, Dd
Hd, Dd, Hd, Dd, Hd, Hd, Dd, Dd^Esd, Dd^Es, Dd, Dd, Dd, Dd, Rd, Rd, Dd, Dd, Dd, Dd, Dd, Dd, Dd, Dd, Dd, Dd^Edpp, Dd, Dd, Dd^Edpp, Dd, Dd, Dd^Edpp, Dd
Hd, Dd, Dd, Hd, Dd, Dd, Dd, Dd, Dd, Dd, Dd, Dd, Dd, Rd, Dd, Rd, Rd, Rd, Rd, Dd, Dd, Hd, Dd, Dd, Dd, Dd^Edpp, Dd, Dd, Dd, Dd, Dd, Dd
Gd, Hd, Dd, Dd, Hd, Dd, Dd, Dd, Dd, Dd, Dd, Dd, Dd, Dd, Dd, Dd, Dd, Dd, Rd, Dd, Dd, Hd, Dd, Hd, Hd, Dd, Dd, Dd, Dd, Dd, Dd, Dd
Dd^Do, Dd^Ftd, Dd, Dd, Dd, Dd, Dd, Hd, Hd, Dd^Edpp, Dd, Dd^Es, Dd, Rd, Dd, Dd, Dd, Dd, Rd, Dd, Dd, Dd, Dd, Dd, Dd, Hd, Dd, Dd, Dd, Dd, Dd, Dd
Dd^Ftd, Gs^Ftp, Dd, Dd, Dd^Es, Dd, Hd, Dd, Dd, Dd, Dd, Dd, Dd, Dd, Rd, Dd, Dd, Dd, Rd, Dd, Dd, Dd, Dd^Edpp, Dd, Dd, Hd, Dd, Dd, Dd, Dd^Edpp, Dd, Dd
Dd, Dd, Hd, Dd, Hd, Hd, Dd, Dd, Dd, Dd, Dd, Dd, Dd, Rd, Dd, Rd, Rd, Dd, Rd, Dd, Dd, Dd, Dd, Dd, Dd, Hd, Hd, Dd, Dd, Dd, Dd, Dd
Hd, Hd, Dd, Dd, Hd, Dd, Dd, Hd, Dd, Hd, Dd, Dd, Dd, Rd, Rd, Dd, Dd, Rd, Rd, Dd, Dd, Dd, Dd, Dd, Hd, Hd, Dd, Dd, Hd, Dd, Dd, Dd
Hd, Hd, Hd, Hd, Hd, Dd, Hd, Dd, Dd, Dd, Dd^Es, Dd, Dd, Dd, Rd, Dd, Dd, Dd, Dd, Dd, Dd, Hd, Hd, Hd, Hd, Dd, Dd, Hd, Dd, Dd, Dd, Dd
Hd, Hd, Dd, Hd, Dd, Hd, Dd, Dd, Dd, Dd, Dd, Dd, Dd, Dd, Rd, Rd, Rd, Dd, Dd, Dd, Dd, Dd, Dd^Edpp, Dd, Dd, Dd, Hd, Dd, Dd, Dd, Dd, Dd
Dd, Dd, Dd, Hd, Dd, Dd, Dd, Dd, Dd, Dd, Dd, Dd, Dd, Rd, Dd, Dd, Rd, Dd, Dd, Dd, Hd, Dd, Dd, Dd, Dd, Dd, Dd, Dd, Dd, Dd, Dd, Dd
Dd, Dd^Edpp, Dd, Dd, Dd, Dd^Edpp, Dd, Dd^Edpp, Dd, Dd^Edpp, Dd^Edpp, Dd, Dd, Rd, Dd, Dd, Dd, Rd, Dd, Dd, Hd, Dd, Hd, Dd, Hd, Hd, Dd, Dd, Dd, Dd, Dd^Edpp, Dd
Md, Md, Hhd, Dd, Dd, Dd, Dd, Dd, Dd, Dd, Dd, Dd, Dd, Dd, Dd^Edb, Rd, Dd, Rd, Rd, Dd, Dd, Dd, Dd, Hd, Hd, Hd, Dd, Dd, Dd, Dd, Dd, Dd
Hhd, Md, Hhd, Md, Md, Dd, Dd, Dd^Es, Dd, Dd, Dd, Dd, Rd, Rd, Dd, Dd, Dd, Dd, Rd, Rd, Rd, Dd, Dd, Dd, Dd, Hd, Hd, Dd, Dd, Dd, Dd, Dd
Hhd, Md, Hhd, Hhd, Md, Dd, Dd, Dd, Dd, Dd, Dd, Dd, Rd, Dd, Dd, Dd, Rd, Rd, Dd, Rd, Dd^Es, Rd, Rd, Dd, Dd, Dd, Dd^Es, Hd, Dd, Dd, Dd, Dd
Hhd, Md, Hhd, Md, Hd, Hd, Dd, Dd, Dd, Rd, Rd, Dd, Rd, Rd, Dd, Dd, Rd, Dd, Dd, Dd, Dd, Dd, Rd, Dd, Hd, Dd, Dd, Dd^Es, Dd, Dd, Dd, Dd
Hd, Hhd, Hd, Hd, Dd, Dd, Dd, Dd, Rd, Dd, Dd, Dd, Dd, Dd, Hhd, Rd, Hhd, Re, Hhd, Dd, Dd, Dd, Hhd, Hhd, Hd, Hd, Hd, Dd, Dd, Dd, Dd, Dd
Hd, Hd, Hd, Dd, Dd, Dd, Dd^Es, Dd, Rd, Dd^Es, Dd, Dd, Hhd, Hhd, Md, Gd, Md, Re, Md, Hhd, Hhd, Dd^Ftd, Hd, Md, Md, Hhd, Hd, Dd, Dd, Dd, Dd, Dd
Dd, Dd, Hd, Dd^Es, Dd, Dd, Dd, Rd, Dd, Dd, Hd, Hhd, Hhd, Md, Gd^Fts, Gs, Hhd^Vhhr, Gd, Md, Md, Md, Hhd, Hhd, Hhd, Md, Hhd, Hhd, Hd, Hd, Hd, Hd, Dd
Dd, Hd, Dd, Dd, Dd, Rd, Dd, Rd, Dd^Ftd, Dd, Hd, Md, Md^Xm, Md, Gd^Fts, Md, Md, Gs, Chw, Md, Md, Md, Md^Xm, Hhd, Hhd, Md, Md, Hhd, Hhd, Hd, Dd^Edp, Hd
Dd, Hd, Dd, Dd, Dd^Ftd, Dd, Rd, Dd^Ftd, Gd^Fts, Dd, Hhd, Hhd, Hhd, Hhd^Vhhr, Hhd, Md, Wot, Chw, 2 Khw, Chw, Hhd^Vhhr, Md, Md, Md, Hhd, Md, Hhd, Md, Md, Hhd, Hd, Dd
Dd, Dd, Dd, Dd, Dd, Rd, Dd, Dd^Ftd, Gs, Hhd, Md, Md, Hhd, Md, Md, Gd^Fts, Wwt, Wot, Chw, Chw, Gd^Fts, Md, Hhd, Hhd, Md, Md^Xm, Md, Md, Md, Hhd, Hhd, Hd
Dd, Dd, Dd^Ftd, Dd, Dd^Es, Dd, Gd^Fts, Gd^Fts, Gs, Hd, Md, Hhd, Hhd, Hhd, Hhd, Wwt, Md, Md, Md, Gd^Fts, Gd^Fts, Md, Hhd, Md^Xm, Hhd, Md, Md, Md, Md, Md, Md, Md
Dd, Dd, Dd^Ftd, Dd^Ftd, Gd, Rd, Gd, Gs, Dd^Ftd, Hd, Hd, Md, Wwt, Wwt, Wwt, Wwt, Md, Hhd^Vhhr, Hhd, Hhd, Md, Hhd, Md, Md, Hhd, Hhd, Hhd, Md, Md, Md, Md, Md
Dd, Dd, Gs, Gd^Fts, Gs, Dd^Ftd, Gd^Fts, Rd, Rd, Gs, Wwt, Wwt, Md, Hhd, Md, Gd^Fts, Md, Md, Hhd, Md, Hhd, Md^Xm, Hhd, Hhd, Hd, Dd^Ftd, Hd, Md, Md, Md, Md^Xm, Md
Dd, Dd, Dd^Ftd, Dd^Ftd, Wwt, Wwt, Wwt, Dd^Ftd, Wwt, Gd^Fts, Wwt, Hd, Hhd, Md^Xm, Md, Md, Hhd, Hhd, Hhd, Hhd, Hhd, Md, Hd, Hd, Hd, Dd, Dd, Hd, Hd, Hhd, Md^Xm, Md
Dd, Gd^Fts, Gs, Dd^Ftd, Wwt, Wwt, Dd^Vdt, Wwt, Wwt, Wwt, Gs, Hd, Dd^Ftd, Hhd, Md, Md, Md, Md, Md, Md, Md, Md, Hd, Hd, Dd, Dd, Dd^Edb, Dd, Hd, Hd, Hd, Md
Dd, Dd, Gd^Fts, Wwt, Wwt, Dd^Ftd, Dd^Ftd, Wwf, Wwt, Wwt, Gd, Dd^Ftd, Dd, Hhd, Dd, Hhd, Hd, Hhd, Hd, Hhd, Hhd, Hhd, Hd, Dd, Dd^Edpp, Dd, Dd, Dd, Dd, Dd, Hd, Hd
Dd, Rd, Dd^Ftd, Gd, Wwt, Wwf, Wwt, Wwt, Gs, Gd^Fts, Dd, Dd, Dd^Edpp, Dd, Dd, Dd, Dd, Hd, Dd, Hd, Hd, Hd, Dd, Dd, Dd, Dd, Dd, Dd, Dd, Hd, Dd, Dd
Dd, Gd, Ds, Wwg, Wwt, Wwt, Dd^Ftd, Ds, Dd^Ftd, Dd, Dd, Dd^Edpp, Rd, Rd, Rd, Rd, Dd, Dd^Edb, Dd^Edb, Dd, Rd, Dd, Rd, Dd, Dd, Dd, Dd, Dd^Edpp, Dd^Edpp, Dd, Dd, Dd
Ds, Ds, Wwf, Wwf, Wwf, Gd^Fts, Gs, Dd, Dd, Dd, Dd, Dd, Rd, Dd, Dd, Dd, Dd, Dd, Hd, Dd, Dd, Rd, Rd, Rd, Rd, Dd, Dd, Dd, Dd, Dd^Edpp, Dd, Dd
Wwt, Wwt, Wwt, Wwf, Dd^Edpp, Gd, Rd, Dd^Edpp, Dd, Dd, Rd, Rd, Dd, Dd, Dd, Dd, Hd, Hd, Dd, Hd, Dd, Dd, Hd^Edb, Rd, Rd, Dd, Dd, Dd, Dd, Dd, Dd, Dd
Wwt, Wwt, Ds, Ds, Dd^Ftd, Dd, Dd, Dd, Rd, Dd, Hd, Dd, Hd, Hd, Hd, Dd^Edb, Dd^Dc, Dd, Dd, Hd, Dd, Dd, Dd, Dd, Rd, Dd, Rd, Dd, Dd, Dd, Dd, Dd
Dd, Dd, Dd^Edpp, Dd, Dd, Dd^Esd, Dd, Dd, Rd, Dd, Hd, Hd, Dd^Dc, Dd, Dd, Dd, Dd, Dd, Hd, Hd, Dd, Dd^Dc, Hd, Hd, Dd, Rd, Dd, Rd, Dd, Dd, Dd, Dd
Dd, Dd, Dd^Edpp, Dd, Dd, Dd, Dd, Dd, Rd, Rd, Dd^Edb, Dd, Dd, Dd, Qxe, Hd, Hd, Hd, Dd, Qxe, Qxe, Dd, Hd, Dd, Dd, Dd, Dd, Rd, Rd, Dd, Dd, Dd^Edpp
Dd, Dd, Dd^Edpp, Dd, Dd, Dd, Dd, Dd, Rd, Dd, Dd, Dd, Hd, Qxe, Dd, Qxe, Hd, Dd, Dd, Hd, Hd, Qxe, Qxe, Dd, Dd^Dc, Dd, Dd^Edb, Dd, Rd, Dd, Dd, Dd
Dd, Dd, Dd^Esd, Dd^Esd, Dd, Dd, Dd, Dd, Rd, Dd, Hd, Hd, Dd^Edb, Hd, Dd, Qxe, Dd, Dd, Dd, Dd^Edb, Dd, Qxe, Qxe, Dd, Dd, Dd, Dd, Rd, Dd, Dd, Dd, Dd
Dd, Dd, Dd, Dd^Edpp, Dd^Edpp, Dd, Dd, Dd, Dd, Dd, Hd, Dd^Dc, Dd, Dd, Dd^Edb, Dd, Hhd^Cov, Hhd^Cov, Hhd^Cov, Dd^Edb, Dd, Hd, Hd, Hd, Hd, Dd, Rd, Rd, Dd, Dd^Edpp, Dd, Dd
Dd, Dd, Dd^Edpp, Dd, Dd, Dd, Dd, Dd, Rd, Hd, Qxe, Dd, Qxe, Dd, Dd, Dd, Hhd^Cov, Md^Kov, Hhd^Cov, Dd, Dd, Hd, Dd, Dd^Edb, Dd^Edb, Hd, Rd, Rd, Dd, Dd^Edpp, Dd^Edpp, Dd
Dd, Dd, Dd, Dd, Dd, Dd, Dd, Rd, Dd^Edb, Dd, Dd, Qxe, Hd, Dd, Qxe, Dd, Dd, Hhd^Cov, Dd, Dd^Edb, Dd, Hd, Dd, Dd, Dd, Dd, Rd, Dd, Dd, Dd, Dd, Dd
Dd, Dd, Dd, Dd, Dd, Dd, Dd, Rd, Dd, Dd, Dd^Dc, Hd, Hd, Dd, Qxe, Dd, Dd, Dd, Dd, Dd, Dd^Edb, Qxe, Dd, Dd^Dc, Hd, Hd, Rd, Dd, Dd, Dd, Dd, Dd
Dd, Dd, Dd, Dd, Dd, Dd, Dd, Rd, Qxe, Qxe, Hd, Hd, Dd, Dd, Dd, Dd, Hd, Hd, Hd, Dd, Dd, Qxe, Dd, Dd^Edb, Hd, Rd, Dd, Dd, Dd, Dd, Dd, Dd
Dd, Dd, Dd, Dd, Dd, Dd, Dd, Rd, Qxe, Hd, Dd^Edb, Hd, Dd, Dd^Esd, Dd, Hd, Dd, Dd^Edb, Dd^Dc, Hd, Hd, Qxe, Hd, Dd, Rd, Rd, Dd, Dd, Dd, Dd, Dd, Dd^Edpp
Dd, Dd, Dd, Dd, Dd, Dd, Dd, Rd, Dd, Dd^Dc, Dd, Dd, Hd, Qxe, Qxe, Hd, Hd, Dd, Dd, Hd, Dd, Qxe, Rd, Rd, Dd, Rd, Dd, Dd, Dd, Dd, Dd, Dd
Dd^Esd, Dd, Dd, Dd, Dd, Dd, Dd, Rd, Dd, Hd, Hd, Hd, Dd, Hd, Hd, Qxe, Hd, Dd, Qxe, Qxe, Dd, Rd, Rd, Dd^Edb, Dd, Dd, Dd, Dd^Edpp, Dd, Dd, Dd, Dd
Dd, Dd, Dd, Dd^Esd, Dd^Esd, Dd, Dd, Rd, Dd, Dd, Dd^Edb, Dd, Dd, Dd^Dc, Hd, Qxe, Qxe, Qxe, Rd, Dd, Dd, Dd, Rd, Dd, Dd, Dd, Dd, Dd^Edpp, Dd, Dd, Dd, Dd
Dd, Dd, Dd, Dd, Dd, Dd, Dd, Rd, Rd, Dd, Dd, Dd, Dd, Dd, Qxe, Qxe, Rd, Rd, Dd, Rd, Rd, Rd, Rd, Dd, Dd, Dd, Dd^Edpp, Dd, Dd, Dd, Dd, Dd
Dd, Dd^Edpp, Dd, Dd, Dd, Dd, Dd, Dd, Rd, Dd, Dd, Dd, Dd, Dd, Dd, Dd, Rd, Dd, Dd, Dd, Dd, Dd, Dd, Dd, Dd, Dd, Dd, Dd, Dd, Dd, Dd, Dd
Dd, Dd, Dd, Dd, Dd, Dd, Dd, Dd, Dd, Rd, Dd, Dd, Dd, Dd, Rd, Rd, Dd, Dd, Dd, Dd^Edpp, Dd, Dd, Dd, Dd, Dd, Dd, Dd, Dd, Dd, Dd^Edpp, Dd^Edpp, Dd
Dd, Dd, Dd^Edpp, Dd, Dd, Dd, Dd, Dd, Dd, Rd, Dd, Rd, Rd, Dd, Rd, Dd, Dd, Dd, Dd, Dd, Dd^Edpp, Dd, Dd, Dd, Dd, Dd, Dd, Dd, Dd, Dd, Dd^Edpp, Dd
Dd^Edpp, Dd, Dd, Dd, Dd, Dd, Dd, Dd, Dd, Rd, Dd, Dd, Dd, Rd, Rd, Dd, Dd, Dd, Dd, Dd, Dd, Dd, Dd, Dd, Dd^Edpp, Dd, Dd, Dd, Dd, Dd, Dd, Dd
Dd, Dd^Edpp, Dd, Dd, Dd, Dd, Dd, Dd, Rd, Rd, Dd, Dd, Dd, Rd, Dd, Rd, Rd, Dd, Dd, Dd, Dd, Dd, Dd, Dd, Dd, Dd, Dd, Dd, Dd, Dd, Dd, Dd
Dd, Dd, Dd, Dd, Dd, Dd, Dd, Dd, Dd, Rd, Rd, Dd, Dd, Rd, Dd, Dd, Dd, Rd, Dd, Dd, Dd^Edpp, Dd, Dd, Dd^Edpp, Dd^Edpp, Dd, Dd, Dd, Dd, Dd, Dd, Dd
Dd, Dd, Dd, Dd, Dd, Dd, Dd, Dd, Dd, Rd, Rd, Dd, Dd, Rd, Dd, Dd, Dd, Rd, Dd, Dd^Edpp, Dd, Dd, Dd, Dd, Dd, Dd^Edpp, Dd, Dd, Dd, Dd, Dd^Edpp, Dd
Dd, Dd, Dd, Dd, Dd, Dd, Dd, Dd, Dd, Dd, Dd, Rd, Dd, Rd, Dd, Dd, Dd, Rd, Rd, Dd, Dd, Dd, Dd, Dd, Dd, Dd^Edpp, Dd, Dd, Dd, Dd, Dd^Edpp, Dd^Edpp
Dd, Dd, Dd, Dd, Dd, Dd^Edpp, Dd, Dd, Dd, Dd, Dd, Dd, Dd, Rd, Dd, Dd, Rd, Rd, Rd, Dd, Dd, Dd, Dd, Dd, Dd, Dd, Dd, Dd, Dd, Dd, Dd^Edpp, Dd
Dd, Dd, Dd, Dd, Dd, Dd, Dd, Dd, Dd, Dd, Dd, Chr^Dr, Khr, Rd, Rd, Rd, Dd, Dd, Dd, Dd, Dd, Dd, Dd^Dr, Dd, Dd, Dd, Dd, Dd, Dd, Dd^Edpp, Dd, Dd
Dd, Dd, Dd, Dd, Dd, Dd, Dd, Dd, Chr, Chr, Dd, Dd, Chr, Rd, Rd, Dd, Dd, Chr, Chr, Dd, Dd, Dd, Dd, Dd, Dd, Dd, Dd, Dd, Dd, Dd^Edpp, Dd, Dd
Dd, Dd, Dd, Dd, Dd^Dr, Dd, Chr, Dd, Dd, Dd, Dd, Dd, Rd, Rd, Rd, Dd, Dd, Dd, Dd, Chr, Dd, Chr^Dr, Dd, Dd, Chr, Dd, Dd, Dd, Dd, Dd, Dd, Dd
Dd, Dd, Dd, Chr, Dd, Dd, Dd, Dd, Dd, Dd, Dd, Dd, Rd, Rd, Rd, Dd, Dd, Dd, Dd, Dd, Dd, Dd, Dd, Dd, Dd, Chr, Chr, Dd, Dd, Dd, Dd, Dd
