Hhd, Hhd, Hhd, Dd, Hd, Dd, Hhd, Hd, Hhd, Hhd, Hhd, Rd, Rd, Rd, Rd, Rd, Dd, Dd, Dd, Dd, Hd, Hd, Hd, Hhd, Hhd, Hhd, Hhd, Dd, Md, Hhd, Dd, Hhd, Hhd, Dd, Md, Rd, Md, Hhd, Hhd, Hhd, Hhd, Hhd, Hhd, Hhd, Hhd, Hhd
Hhd, Hd, Hhd, Hhd, Hhd, Hd, Hd, Dd, Dd, Dd, Dd^Vdt, Dd, Rd, Rd, Rd, Hd, Dd^Vdt, Hd, Hd, Hd, Hd, Hhd, Hhd, Hd, Md, Hhd, Hhd, Hhd, Md, Hhd, Hhd, Hd, Hhd, Md, Md, Rd, Md, Md, Md, Hhd, Hd, Hd, Hd, Hd, Hd, Hhd
Dd, Hhd, Hhd, Hd, Hhd, Hd, Md, Hhd, Hd, Hd, Hd, Hd, Ce, Ce, Ce, Dd, Hd, Hd, Md, Hhd, Md, Md, Hd, Hd, Md, Md, Md, Hhd, Md, Hhd, Hhd, Hd, Hhd, Hhd, Md, Rd, Md, Md, Md, Hhd, Hd, Hhd, Hhd, Hhd, Hhd, Hhd
Hhd, Hhd, Hd, Hd, Hhd, Hhd, Md, Md, Md, Md, Hd, Ce, Ce, 1 Ke, Ce, Ce, Hd, Md, Md, Md, Md, Md, Hhd, Hd, Md, Hhd, Md, Md, Md, Md, Md, Md, Dd, Hhd, Md, Rd, Hhd, Hhd, Hhd, Hd, Hd, Md, Md, Md, Md, Hhd
Dd, Hd, Hd, Hhd, Hhd, Md, Md, Md, Md, Hhd, Dd, Hd, Dd, Ce, Rd, Dd, Hd, Hhd, Hhd, Md, Md, Md, Md, Md, Hd, Md, Hd, Md, Hhd, Md, Md, Md, Hd, Hhd, Hd, Rd, Hhd, Hd, Hhd, Hd, Hd, Hhd, Hhd, Md, Md, Hhd
Hhd, Hhd, Hd, Hd, Hd, Hd, Hhd, Hd, Hd, Hhd, Dd, Hd, Hd, Hd, Dd, Hd, Dd, Hhd, Hd, Hhd, Hhd, Md, Hhd, Md, Hd, Hhd, Hhd, Hd, Hd, Hd, Hd, Hd, Hhd, Md, Md, Md, Md, Md, Hhd, Md, Hd, Md, Hhd, Md, Hhd, Hhd
Hd, Hhd, Hd, Hd, Hd, Hhd, Hd, Hd, Dd, Hd, Dd, Hd, Dd, Hd, Dd, Rd, Dd, Hhd, Hhd, Hd, Hhd, Hhd, Hd, Hd, Re, Dd, Re, Dd, Dd, Hhd, Dd, Hd, Dd, Hd, Hhd, Hhd, Hhd, Hd, Hd, Hd, Hhd, Hd, Dd, Hd, Hd, Hd
Dd, Dd, Dd, Hhd, Hhd, Hhd, Dd, Hd, Dd, Hd, Dd, Dd, Dd, Dd, Dd, Dd, Rd, Dd, Dd, Hd, Hd, Hd, Dd, Hd, Hd, Dd, Hd, Dd, Re, Dd, Rd, Rd, Hd, Hd, Hd, Hd, Hd, Hhd, Hhd, Hhd, Hd, Hd, Hd, Hd, Hd, Dd
Dd, Dd, Dd, Hd, Dd, Hd, Dd, Hd, Rd, Dd, Dd, Dd, Rd, Dd, Hd, Dd, Rd, Dd, Dd, Dd, Dd, Dd, Dd, Hd, Dd, Rd, Dd, Hd, Re, Dd, Dd, Hd, Rd, Dd, Dd, Dd, Dd, Dd, Dd, Dd, Dd, Dd, Dd, Dd, Dd, Dd
Dd, Dd, Ds, Dd, Rd, Rd, Rd, Rd, Dd, Hd, Dd, Ds, Rd, Dd, Hd, Hd, Dd, Hd, Dd, Hd, Dd, Dd, Dd, Hd, Dd, Rd, Dd, Hd, Re, Dd, Hd, Hd, Ds, Dd^Do, Ds, Dd, Dd, Dd, Re, Re, Hd, Dd, Hd, Dd, Dd, Dd
Dd, Rd, Dd, Hd, Rd, Dd, Re, Ds, Re, Dd, Hd, Hd, Dd, Dd, Dd^Do, Hd, Dd, Dd, Rd, Re, Dd, Hd, Dd, Hd, Dd, Dd, Rd, Rd, Rd, Hd, Dd, Rd, Dd, Dd, Hd, Dd, Re, Dd, Rd, Hd, Hd, Hd, Ds, Ds, Dd, Dd
Dd, Rd, Dd, Rd, Dd, Ds, Dd, Dd, Dd, Dd, Rd, Dd, Ds, Rd, Hd, Hd, Dd, Dd, Dd, Rd, Rd, Ds, Re, Dd, Hd, Dd, Dd, Dd, Dd, Hd, Dd, Dd, Hd, Hd, Dd, Re, Rd, Rd, Dd, Dd, Hd, Rd, Ds, Dd, Dd, Dd
Dd, Re, Dd, Dd, Hd, Dd, Re, Re, Ds, Dd, Rd, Dd, Dd, Hd, Dd, Hd, Dd, Hd, Ds, Dd, Hd, Rd, Dd, Dd, Hd, Hd, Dd, Dd, Hd, Hd, Re, Hd, Ds, Hd, Ds, Re, Rd, Ds, Dd, Rd, Rd, Re, Dd, Dd, Dd, Dd
Rd, Ds, Dd, Hd, Dd, Re, Re, Dd, Hd, Ds, Hd, Dd, Dd, Dd, Dd, Dd, Re, Dd, Ds, Dd, Dd, Rd, Dd, Ds, Dd, Re, Ds, Re, Dd, Re, Dd, Ds, Ds, Dd, Hd, Dd, Dd, Re, Dd, Rd, Rd, Hd, Hd, Dd, Dd, Dd
Ds, Ds, Hd, Dd, Rd, Rd, Re, Ds, Dd, Dd, Hd, Dd, Dd, Dd, Hd, Dd, Re, Dd, Dd, Dd, Dd, Rd, Rd, Dd, Dd, Dd, Dd, Rd, Dd, Dd, Dd, Dd, Dd, Dd, Dd, Hd, Dd, Hd, Ds, Dd, Hd, Dd, Hd, Dd, Dd, Dd
Dd, Dd, Hd, Re, Hd, Dd, Ds, Hd, Dd, Dd, Dd, Dd, Dd, Hd, Hd, Dd, Dd, Dd, Rd, Rd, Dd, Dd, Re, Rd, Re, Rd, Dd, Dd, Hd, Dd, Dd, Rd, Dd, Rd, Dd, Dd, Rd, Dd, Ds, Ds, Ds, Dd, Ds, Dd, Dd, Dd
Dd, Dd, Hd, Dd, Hd, Dd, Dd, Dd, Dd, Dd, Rd, Dd, Dd, Dd, Dd, Hd, Hd, Rd, Re, Dd, Dd, Dd, Dd, Dd, Dd, Re, Dd, Dd, Hd, Hd, Hd, Dd, Hd, Dd, Dd, Dd, Dd, Rd, Rd, Dd, Dd, Dd, Re, Re, Dd, Dd
Dd, Dd, Dd, Hd, Dd, Dd, Dd, Dd, Dd, Dd, Hd, Rd, Rd, Dd, Dd, Rd, Dd, Re, Rd, Rd, Rd, Rd, Dd, Rd, Dd, Dd, Hd, Hd, Re, Dd, Dd, Hd, Dd, Hd, Rd, Rd, Dd, Dd, Dd, Rd, Dd, Dd, Ds, Dd, Dd, Dd
Dd, Hd, Dd, Hd, Dd, Dd, Hd, Hd, Dd, Dd, Hd, Dd^Do, Hd, Dd, Hd, Dd, Hd, Dd, Rd, Dd, Dd^Dc, Dd, Dd, Rd, Dd, Dd, Hd, Dd, Dd, Dd, Dd^Dc, Dd, Hd, Hd, Dd, Dd, Hd, Hd, Dd, Dd, Dd, Dd, Hd, Hd, Hd, Dd
Dd, Hd, Dd, Dd, Dd, Dd, Hd, Dd, Dd, Hd, Dd, Hd, Hd, Dd, Dd, Hd, Hd, Hd, Rd, Dd, Dd, Dd, Rd, Dd, Dd, Dd, Hd, Ds, Dd, Dd, Ds, Dd, Dd, Re, Ds, Dd, Hd, Hd, Dd, Rd, Dd, Hd, Hd, Hd, Dd, Dd
Dd, Hd, Dd, Re, Re, Rd, Dd, Hd, Dd^Dc, Dd, Hd, Hd, Dd, Dd, Ds, Dd, Dd, Hd, Hd, Dd, Re, Dd, Dd, Re, Dd^Do, Re, Dd, Hd, Hd, Dd, Dd, Dd, Hd, Re, Dd, Ds, Hd, Dd^Do, Dd, Rd, Dd, Dd, Hd, Hd, Dd, Dd
Dd, Hd, Dd, Rd, Rd, Rd, Dd, Dd, Dd, Dd, Dd, Dd, Dd, Re, Re, Rd, Ds, Dd, Hd, Hd, Dd, Dd, Dd, Rd, Rd, Re, Dd, Dd, Dd, Dd, Dd, Dd, Dd, Hd, Hd, Hd, Hd, Dd, Hd, Rd, Re, Hd, Hd, Dd, Dd, Dd
Dd, Hd, Re, Re, Dd, Rd, Dd, Dd, Hd, Hd, Dd, Dd^Do, Dd, Rd, Hd, Re, Dd, Hd, Dd, Hd, Dd, Hd, Hd, Dd, Dd, Re, Re, Dd, Re, Re, Dd, Rd, Ds, Ds, Hd, Hd, Dd, Hd, Hd, Rd, Dd, Hd, Hd, Dd, Hd, Dd
Dd, Dd, Hd, Dd, Dd, Rd, Dd, Dd, Hd, Dd, Hd, Ds, Hd, Hd, Dd, Rd, Re, Hd, Dd, Dd, Hd, Rd, Ds, Dd, Dd, Dd, Rd, Dd, Dd, Hd, Hd, Rd, Rd, Re, Dd, Hd, Ds, Hd, Hd, Hd, Dd, Rd, Dd, Ds, Hd, Hd
Dd, Hd, Hd, Hd, Hd, Hd, Rd, Dd, Hd, Hd, Rd, Hd, Hd, Dd, Ds, Ds, Dd, Dd, Rd, Hd, Dd, Dd, Re, Hd, Hd, Dd, Rd, Dd, Dd, Hd, Ds, Ds, Hd, Rd, Rd, Dd, Dd, Dd, Rd, Hd, Dd, Rd, Dd, Hd, Dd, Dd
Dd, Hd, Ds, Hd, Dd, Dd, Dd, Dd, Hd, Hd, Dd, Rd, Dd, Hd, Hd, Hd, Hd, Hd, Dd, Dd, Hd, Rd, Hd, Dd, Hd, Dd, Hd, Hd, Hd, Dd, Ds, Re, Dd, Hd, Dd, Dd, Rd, Dd, Hd, Hd, Ds, Rd, Ds, Re, Dd, Dd
Dd, Dd, Ds, Dd, Rd, Dd, Ds, Ds, Dd, Dd, Dd, Rd, Dd, Dd, Dd, Dd, Dd, Dd, Dd, Ds, Dd, Hd, Dd, Dd, Dd, Dd, Rd, Dd, Hd, Hd, Dd, Re, Dd, Hd, Dd, Rd, Hd, Hd, Dd, Hd, Ds, Rd, Rd, Re, Dd, Dd
Re, Re, Rd, Re, Ds, Dd, Rd, Re, Re, Ds, Re, Re, Rd, Re, Dd, Dd, Re, Dd, Dd, Re, Dd, Re, Re, Dd, Dd, Dd, Ds, Ds, Ds, Ds, Re, Dd, Re, Dd, Re, Hd, Rd, Rd, Dd, Dd, Re, Dd, Ds, Re, Re, Dd
Re, Re, Dd, Dd, Re, Dd, Rd, Re, Ds, Ds, Dd, Dd, Rd, Dd, Ds, Re, Ds, Ds, Ds, Ds, Ds, Re, Ds, Re, Ds, Re, Re, Ds, Ds, Rd, Re, Re, Re, Ds, Rd, Rd, Dd, Rd, Dd, Rd, Rd, Re, Re, Dd, Dd, Dd
Dd, Rd, Ds, Dd, Dd, Rd, Rd, Dd, Dd, Dd, Rd, Ds, Dd, Ds, Dd, Dd, Dd, Dd, Rd, Dd, Dd^Ftd, Dd, Rd, Rd, Rd, Dd, Rd, Dd, Dd, Dd, Dd, Dd, Dd, Rd, Dd, Rd, Dd, Re, Dd, Dd, Dd, Rd, Rd, Re, Re, Dd
Dd, Dd, Dd, Dd^Ftd, Dd, Dd, Gd^Fts, Dd, Dd^Ftd, Dd, Dd^Ftd, Dd, Dd, Dd, Dd^Ftd, Dd^Ftd, Gd^Fts, Dd, Dd^Ftd, Dd^Ftd, Gs^Ftp, Rd, Dd, Dd, Dd, Dd, Dd, Dd^Ftd, Gd^Fts, Dd, Gd^Fts, Dd, Gs^Ftp, Dd, Dd^Ftd, Dd^Ftd, Dd^Ftd, Dd, Dd, Rd, Dd^Ftd, Dd^Ftd, Dd^Ftd, Dd, Dd, Re
Gd^Fts, Gd^Fts, Gs^Ftp, Dd^Ftd, Dd, Gd^Fts, Rd, Gd^Fts, Gd^Fts, Dd, Dd, Dd^Ftd, Gd^Fts, Gd^Fts, Gs^Ftp, Gd^Fts, Rd, Gd^Fts, Gd^Fts, Dd, Dd^Ftd, Dd, Dd^Ftd, Gs^Ftp, Dd, Gd^Fts, Gs^Ftp, Rd, Dd^Ftd, Gs^Ftp, Dd^Ftd, Dd, Dd^Ftd, Gd^Fts, Gd^Fts, Dd, Dd^Ftd, Dd, Dd^Ftd, Dd^Ftd, Dd, Gd^Fts, Gd^Fts, Gd^Fts, Dd^Ftd, Dd
Gs^Ftp, Gs^Ftp, Gd^Fts, Gs^Ftp, Dd^Ftd, Dd^Ftd, Gs^Ftp, Gd^Fts, Gs^Ftp, Gd^Fts, Gs^Ftp, Rd, Dd, Rd, Dd, Dd, Rd, Rd, Dd^Ftd, Gd^Fts, Gd^Fts, Gd^Fts, Dd, Gd^Fts, Rd, Rd, Dd^Ftd, Rd, Rd, Dd^Ftd, Rd, Rd, Dd^Ftd, Rd, Rd, Rd, Dd, Gd^Fts, Rd, Gd^Fts, Dd, Rd, Rd, Gd^Fts, Rd, Dd
Gs^Ftp, Dd, Gd^Fts, Dd, Rd, Rd, Dd, Dd, Rd, Dd, Gd, Hd, Gs^Ftp, Gd^Fts, Dd^Ftd, Gs^Ftp, Gs^Ftp, Dd^Ftd, Dd, Dd^Ftd, Rd, Gd^Fts, Hd, Gd^Fts, Gd, Dd^Ftd, Gll, Dd, Dd^Ftd, Gll, Dd, Dd^Ftd, Gs^Ftp, Dd, Rd, Dd^Ftd, Gs^Ftp, Rd, Dd, Rd, Gd^Fts, Dd, Dd^Ftd, Gd^Fts, Gd^Fts, Dd
Dd, Dd, Dd^Ftd, Dd^Ftd, Rd, Gd, Gd, Gs^Ftp, Dd^Ftd, Dd^Ftd, Hd, Hd, Dd^Ftd, Dd^Ftd, Hd, Dd^Ftd, Hd, Gd^Fts, Dd^Ftd, Dd^Ftd, Dd^Ftd, Gs^Ftp, Gd, Gs^Ftp, Gd, Gs^Ftp, Dd^Ftd, Gd^Fts, Gs^Ftp, Gd^Fts, Gd, Dd^Ftd, Dd^Ftd, Gd, Gs^Ft, Gll, Dd^Ftd, Dd^Ftd, Gd^Fts, Gd^Fts, Rd, Gll, Rd, Gd^Fts, Gs^Ftp, Dd
Dd, Dd^Ftd, Gll, Gs^Ftp, Gll, Gs^Ftp, Gd^Fts, Dd^Ftd, Hd, Gs^Ftp, Gd^Fts, Dd^Ftd, Rd, Gd, Rd, Gd^Fts, Gd^Fts, Rd, Rd, Rd, Rd, Gd^Fts, Dd^Ftd, Rd, Gd^Fts, Dd^Ftd, Dd^Ftd, Gd, Rd, Dd^Ftd, Gd^Fts, Rd, Gd, Gs^Ft, Dd^Ftd, Gd^Fts, Gll, Dd^Ftd, Dd^Ftd, Gd, Gd^Fts, Rd, Dd^Ftd, Rd, Rd, Dd^Ftd
Rd, Dd^Ftd, Rd, Gs^Ftp, Gd^Fts, Rd, Dd^Ftd, Dd^Ftd, Gd^Fts, Gd^Fts, Rd, Rd, Hd, Rd, Dd, Gd^Fts, Dd, Dd, Hd, Dd, Hd, Dd, Dd, Dd, Rd, Dd, Rd, Dd, Hd, Dd^Ftd, Hd, Dd, Dd^Ftd, Dd^Ftd, Dd^Ftd, Dd^Ftd, Hd, Dd, Dd, Dd^Ftd, Dd^Ftd, Gd^Fts, Dd, Gs^Ftp, Dd^Ftd, Dd^Ftd
Rd, Gd^Fts, Gd, Gd^Fts, Gd, Gd^Fts, Gd, Gd^Fts, Dd, Gd, Dd, Dd, Dd, Dd, Rd, Dd, Hd, Hd, Dd, Hd, Dd^Vda, Rd, Rd, Hd, Hd, Dd, Dd, Dd^Vda, Rd, Dd, Rd, Hd, Dd, Hd, Dd, Dd, Hd, Hd, Hd, Rd, Dd, Dd, Rd, Dd, Dd, Hd
Dd, Hd, Gd^Fts, Hd, Hd, Hd, Rd, Dd, Hd, Dd, Hd, Rd, Hd, Dd, Hd, Rd, Hd, Dd, Ql, Dd, Dd, Rd, Dd, Dd, Ql, Ql, Dd, Hd, Rd, Hd, Rd, Rd, Hd, Hd, Dd, Dd^Vda, Hd, Rd, Rd, Rd, Rd, Rd, Dd, Hd, Hd, Hd
Dd, Dd, Hd, Hd, Hd, Hd, Hd, Rd, Rd, Rd, Dd, Hd, Qxe, Hd, Rd, Rd, Rd, Rd, Hd, Dd, Dd, Ql, Dd, Ql, Dd, Dd, Ql, Hd, Rd, Rd, Hd, Dd^Vda, Rd, Rd, Md, Hd, Dd, Dd, Rd, Rd, Rd, Dd, Dd, Rd, Dd, Hd
Dd, Hd, Rd, Rd, Rd, Rd, Hd, Dd^Vda, Rd, Dd, Qxe, Hd, Dd, Qxe, Dd, Dd^Vda, Qxe, Rd, Hd, Ql, Cd, Cd, Cd, Cd, Cd, Cd, Cd, Dd, Dd, Dd, Qxe, Qxe, Md, Md, Md^Xm, Md, Md, Hd, Dd, Hd, Rd, Rd, Dd, Rd, Dd, Dd
Dd, Rd, Dd, Rd, Dd, Dd, Dd, Qxe, Dd, Dd, Cd, Dd, Cd, Dd, Cd, Qxe, Hhd, Hd, Hhd, Hd, Hhd, Dd^Vda, Cd, 2 Kd, Cd, Ql, Dd^Vda, Hhd, Hhd, Dd, Dd, Hhd, Cd, Md^Xm, Cd, Md^Xm, Cd, Hd, Hhd, Dd, Hd, Hd, Hd, Hd, Hd, Hd
Dd, Hd, Cdr, Cdr, Cdr, Rd, Rd, Qxe, Dd, Cd, Qxe, Cd, 3 Kd, Cd, Dd^Vda, Cd, Qxe, Hd, Hhd, Hhd, Hhd, Ql, Hhd, Cd, Hhd, Ql, Hd, Hd, Hhd, Qxe, Dd^Vda, Cd, Md^Xm, Cd, 4 Kd, Cd, Md^Xm, Cd, Md, Qxe, Hhd, Hd, Cdr, Cdr, Cdr, Hd
Dd, Rd, Cdr, Kdr, Cdr, Rd, Dd, Rd, Dd, Qxe, Dd^Vda, Cd, Cd, Cd, Qxe, Dd, Hhd, Hd, Hhd, Ql, Ql, Dd^Vda, Hhd, Ql, Ql, Hhd, Hhd, Hhd, Hhd, Hhd, Md, Md^Xm, Md^Xm, Cd, Cd, Cd, Md^Xm, Md^Xm, Md, Dd^Vda, Hhd, Hhd, Cdr, Kdr, Cdr, Hhd
Hd, Rd, Hd, Cdr, Hd, Hd, Hhd, Hd, Hhd, Hd, Hhd, Qxe, Hd, Hd, Hhd, Hhd, Qxe, Hd, Hhd, Ql, Hhd, Hhd, Ql, Ql, Hhd, Ql, Hhd, Hhd, Hhd, Hhd, Hhd, Md, Hhd, Hhd, Hhd, Hhd, Md, Qxe, Hhd, Hhd, Hhd, Hhd, Hhd, Cdr, Hhd, Hhd
Hd, Hhd, Hd, Hd, Hhd, Hhd, Hd, Hd, Hhd, Hhd, Qxe, Hd, Dd^Vda, Hd, Hhd, Hd, Hhd, Hhd, Hhd, Hhd, Ql, Ql, Hhd, Hhd, Hhd, Ql, Hhd, Hhd, Qxe, Hhd, Hhd, Hhd, Qxe, Qxe, Dd^Vda, Hhd, Hhd, Qxe, Hhd, Hhd, Hhd, Hhd, Hhd, Hhd, Hhd, Hhd
Hhd, Hhd, Hhd, Hhd, Hhd, Hhd, Hhd, Hhd, Hhd, Hhd, Hhd, Hhd, Qxe, Hhd, Hhd, Hhd, Hhd, Hhd, Ql, Hhd, Hhd, Hhd, Hhd, Hhd, Hhd, Ql, Hhd, Hhd, Hhd, Hhd, Hhd, Hhd, Hhd, Qxe, Hhd, Hhd, Qxe, Hhd, Hhd, Hhd, Hhd, Hhd, Hhd, Hhd, Hhd, Hhd
Hhd, Hhd, Hhd, Hhd, Hhd, Hhd, Hhd, Hhd, Hhd, Hhd, Hhd, Qxe, Hhd, Hhd, Hhd, Hhd, Hhd, Hhd, Hhd, Hhd, Hhd, Hhd, Hhd, Hhd, Hhd, Ql, Hhd, Hhd, Hhd, Hhd, Hhd, Hhd, Hhd, Hhd, Hhd, Hhd, Hhd, Hhd, Hhd, Hhd, Hhd, Hhd, Hhd, Hhd, Hhd, Hhd
