Urb, Urb, Urb, Xu, Xu, Xu, Xu, Xu, Xu, Xu, Xu, Xu, Xu, Xu, Xu, Xu, Xu, Xu, Xu, Xu, Xu, Xu, Xu, Xu, Xu, Xu, Xu, Xu, Xu, Xu, Xu, Xu, Xu, Xu, Xu, Xu, Xu, Xu, Xu, Xu, Xu, Xu, Xu, Xu, Xu, Ql, Ql, Ql, Xu, Xu, Xu, Xu, Xu
Urb, Urb, Urb, Urb, Urb, Xu, Uu, Xu, Uu, Xu, Uu, Xu, Uue, Xu, Uue, Xu, Uh, Xu, Uh, Xu, Xu, Xu, Xu, Uu^Tf, Ur, Uu, Ur, Uh, Uh, Uu^Tf, Ur, Uh, Uu, Uu, Uu, Ur, Ur, Uu, Uu, Uu^Tf, Ur, Ur, Uu, Xu, Ql, Ql, Ql, Ql, Xu, Xu, Xu, Xu, Xu
Xu, Urb, Urb, Urb, Urb, Uu^Tf, Uu, Chr, Uu, Uh, Chr, Chr, Rr^Vd, Uu, Chr, Uue, Uue, Uh, Uu^Tf, Uu, Uue, Xu, Uu, Ur, Xu, Uh, Xu, Ur, Xu, Uu, Xu, Xu, Xu, Xu, Xu, Uu^Tf, Xu, Xu, Xu, Xu, Xu, Xu, Xu, Uu, Ur, Ql, Xu, Xu, Xu, Xu, Xu, Xu, Xu
Xu, Xu, Xu, Uu, Urb, Rr^Vd, Qxe, Chr, Chr, Qxe, Chr, Qxe, Chr, Chr, Uu, Uu, Uh, Uu^Tf, Uu^Tf, Uh, Uu^Tf, Uu, Uu, Xu, Xu, Xu, Xu, Xu, Xu, Xu, Xu, Xu, Xu, Xu, Ql, Xu, Ql, Ql, Ql, Xu, Xu, Xu, Uh, Uh, Uu, Xu, Xu, Xu, Xu, Xu, Xu, Xu, Ql
Xu, Xu, Xu, Uue, Urb, Uu, Chr, Qxe, Chr, Chr, 2 Khr, Chr, Chr, Qxe, Chr, Uu, Uh, Rr^Vd, Uh, Uu, Uu^Tf, Uu^Tf, Xu, Xu, Xu, Xu, Xu, Xu, Xu, Xu, Xu, Xu, Uh, Ql, Ql, Ql, Ql, Uh, Ql, Ql, Xu, Xu, Uu, Ur, Xu, Xu, Xu, Xu, Ql, Ql, Ql, Ql, Xu
Xu, Xu, Xu, Uue, Uue, Urb, Qxe, Chr, Chr, Chr, Chr, Chr, Chr, Chr, Uu, Uu, Uue, Uue, Uu^Tf, Uue, Uue, Uue, Xu, Xu, Xu, Xu, Xu, Xu, Xu, Xu, Xu, Qxe, Qxe, Ql, Ql, Xu, Uu, Ql, Ql, Xu, Xu, Uu^Tf, Ur, Ur, Xu, Xu, Ql, Ql, Xu, Xu, Xu, Xu, Xu
Xu, Xu, Xu, Uue, Uue, Uu, Uu^Tf, Chr, Qxe, Qxe, Chr, Qxe, Qxe, Chr, Uu, Uu, Uu, Uue, Uh, Uh, Uu^Tf, Uue, Xu, Xu, Xu, Xu, Xu, Xu, Xu, Xu, Uu, Uu^Tf, Qxe, Uu, Qxe, Uu, Qxe, Xu, Ql, Xu, Qxe, Qxe, Ur, Uu, Xu, Xu, Ql, Xu, Xu, Xu, Xu, Xu, Xu
Xu, Xu, Xu, Rr^Vd, Uu, Uue, Uu^Tf, Uu, Uh, Qxe, Chr, Qxe, Uu, Chr, Uu^Tf, Rr^Vd, Uue, Uue, Uu^Tf, Uh, Xu, Xu, Xu, Xu, Xu, Xu, Xu, Xu, Xu, Xu, Uu, Uu, Chr, Chr, Chr, Uu, Xu, Xu, Xu, Ql, Ql, Ql, Ur, Qxe, Ql, Ql, Ql, Ql, Xu, Xu, Xu, Xu, Xu
Xu, Xu, Xu, Uh, Uu, Uue, Rr^Vd, Uh, Uh, Uh, Uu, Rr^Vd, Uu^Tf, Uu, Uue, Uue, Uue, Uu, Uu^Tf, Xu, Xu, Uu^Tf, Xu, Xu, Xu, Xu, Xu, Xu, Xu, Uu^Tf, Uu^Tf, Uh, Chr, 4 Kud, Uh, Uu, Xu, Xu, Uu, Xu, Xu, Qxe, Uh, Uu, Uu, Ql, Ur, Uu, Xu, Xu, Xu, Xu, Xu
Xu, Xu, Xu, Ur, Ur, Uue, Uue, Uue, Uue, Uh, Uu, Uu, Uu^Tf, Uue, Ql, Ql, Ql, Uue, Uu, Uh, Uh, Uu^Tf, Uu^Tf, Xu, Xu, Xu, Xu, Uu, Uh, Uh, Uu, Uh, Ur, Uh, Xu, Xu, Uu, Uu, Uu, Uu, Uu, Xu, Xu, Ur, Ur, Uue, Ur, Uue, Uu, Xu, Xu, Xu, Xu
Xu, Xu, Xu, Xu, Ur, Uu, Xu, Xu, Xu, Xu, Xu, Uu^Tf, Uue, Uue, Ql, Ql, Ql, Uh, Uue, Uu, Uu, Xu, Xu, Xu, Xu, Xu, Xu, Uu, Uu, Uh, Uh, Ur, Ur, Xu, Xu, Xu, Xu, Uu, Uu, Uu, Xu, Xu, Xu, Uu, Ur, Uu, Xu, Uu, Xu, Uu, Xu, Xu, Xu
Xu, Xu, Uue, Uue, Uu^Tf, Xu, Xu, Xu, Xu, Xu, Xu, Uu, Uh, Uue, Uue, Uue, Ql, Uue, Ql, Uue, Uue, Uu, Xu, Xu, Xu, Xu, Uh, Xu, Uu, Uu, Uu, Uu^Tf, Ur, Xu, Xu, Xu, Uu, Xu, Xu, Xu, Xu, Xu, Uu, Ur, Uu, Uu^Tf, Xu, Xu, Xu, Uue, Xu, Xu, Xu
Xu, Xu, Xu, Uu, Uu, Uu, Uue, Xu, Xu, Xu, Xu, Xu, Xu, Xu, Uue, Uh, Ql, Uue, Uue, Uue, Uu, Uu^Tf, Xu, Xu, Xu, Uu^Tf, Uu, Uu, Xu, Uu, Xu, Uu, Ur, Uu, Uu^Tf, Xu, Uu, Xu, Xu, Xu, Xu, Uu^Tf, Uu, Uu, Ur, Xu, Xu, Xu, Uu, Uu, Xu, Xu, Xu
Xu, Xu, Xu, Xu, Xu, Uh, Uue, Uu^Tf, Uu, Uue, Xu, Xu, Xu, Xu, Xu, Uue, Uu, Uu, Uu, Uu, Xu, Xu, Uu^Tf, Xu, Xu, Xu, Xu, Uu, Uh, Uh, Uu, Uu, Xu, Ur, Uu, Uu^Tf, Uu, Xu, Uu, Xu, Xu, Xu, Ur, Uu, Ur, Xu, Xu, Xu, Uu, Xu, Xu, Xu, Xu
Xu, Xu, Xu, Xu, Xu, Uue, Uu, Uu, Xu, Uu, Xu, Xu, Xu, Xu, Xu, Uue, Uu, Ur, Uu^Tf, Xu, Uu^Tf, Xu, Uu, Uh, Uh, Xu, Xu, Uu^Tf, Uu, Uu, Uu^Tf, Xu, Xu, Ur, Uu^Tf, Uh, Uu, Uu, Uu, Uu, Uu, Ur, Uu^Tf, Uh, Uu, Uu^Tf, Xu, Xu, Uue, Xu, Xu, Xu, Xu
Xu, Xu, Xu, Xu, Xu, Ur, Xu, Xu, Ur, Uue, Uue, Xu, Xu, Xu, Xu, Uu, Uue, Uh, Uu, Uh, Uue, Uu, Xu, Ur, Uu, Xu, Xu, Xu, Uu, Uh, Uu, Xu, Uu, Uu, Ur, Uh, Uu, Uh, Xu, Xu, Uu, Uh, Uh, Uh, Uh, Ur, Uu, Uu, Uu, Uu^Tf, Xu, Xu, Xu
Xu, Xu, Xu, Xu, Uh, Ur, Xu, Uh, Uu, Ur, Uu^Tf, Xu, Xu, Xu, Uu, Uu, Xu, Uu, Ur, Uue, Xu, Xu, Xu, Xu, Xu, Ur, Uu, Xu, Xu, Uh, Uu, Uu, Uh, Ur, Ur, Uu, Xu, Xu, Xu, Xu, Xu, Uu, Xu, Uu, Ur, Ur, Uh, Ql, Ql, Ql, Ql, Xu, Xu
Xu, Xu, Xu, Uh, Uu^Tf, Ur, Uu, Uu, Xu, Ur, Xu, Xu, Xu, Ql, Ur, Xu, Xu, Xu, Ur, Uue, Uu^Tf, Xu, Xu, Xu, Xu, Xu, Ur, Xu, Xu, Uu, Xu, Uu, Uu, Uh, Uu^Tf, Ur, Xu, Xu, Xu, Xu, Xu, Xu, Xu, Xu, Uu, Uh, Uu, Xu, Xu, Xu, Ql, Ql, Ql
Xu, Xu, Xu, Xu, Xu, Ur, Xu, Xu, Uu, Ur, Xu, Xu, Ql, Ql, Ur, Xu, Xu, Ur, Uu, Uu, Xu, Xu, Ql, Xu, Xu, Uu, Uh, Xu, Xu, Xu, Xu, Xu, Uu, Uh, Uh, Ur, Xu, Xu, Xu, Xu, Xu, Xu, Xu, Xu, Uu^Tf, Ur, Uu, Uu, Uue, Xu, Xu, Ql, Ql
Xu, Xu, Xu, Xu, Xu, Ur, Uu, Uu, Uu, Ur, Xu, Xu, Xu, Xu, Xu, Uu, Uu, Uu, Uu, Uh, Xu, Ql, Ql, Xu, Uu, Uu, Uu, Xu, Xu, Xu, Xu, Xu, Uu^Tf, Uh, Uh, Ur, Uu, Xu, Uu, Xu, Xu, Xu, Xu, Xu, Xu, Uh, Uu, Xu, Uu, Xu, Xu, Xu, Ql
Xu, Xu, Xu, Xu, Xu, Uu, Ur, Uu^Tf, Uh, Xu, Xu, Xu, Xu, Xu, Uu, Xu, Xu, Ur, Uu^Tf, Uh, Uu, Uu, Uu, Uu, Uu, Ur, Uu, Uh, Uu, Xu, Uu, Uu, Uu, Uu^Tf, Uu, Uh, Uu, Uu, Uu, Xu, Xu, Uu, Xu, Xu, Xu, Xu, Xu, Ur, Ur, Xu, Ql, Xu, Ql
Xu, Xu, Xu, Xu, Ql, Xu, Uu^Tf, Uu, Uu, Uh, Xu, Xu, Xu, Uu, Uu, Uu, Xu, Ur, Uu, Uu, Qxe, Ur, Uu, Qxe, Qxe, Ur, Qxe, Qxe, Qxe, Qxe, Qxe, Qxe, Qxe, Uu, Uu, Uh, Uu, Ur, Xu, Xu, Xu, Uu, Uu^Tf, Xu, Ur, Uu, Xu, Ur, Uu, Ql, Xu, Ql, Xu
Xu, Xu, Xu, Xu, Ql, Xu, Xu, Ur, Uh, Uu, Uu, Uu^Tf, Uh, Xu, Xu, Xu, Uh, Uu, Qxe, Qxe, Chr, Ur, Ur, Chr, Chr, Uu, Ur, Chr, Rr^Vd, Chr, Ur, Chr, Chr, Qxe, Qxe, Qxe, Qxe, Ur, Uu, Xu, Ur, Ur, Ur, Ur, Uu^Tf, Ur, Ur, Ur, Uu^Tf, Xu, Xu, Xu, Xu
Xu, Xu, Xu, Xu, Ql, Uu, Uh, Uu, Uu, Ur, Ur, Uu, Ur, Ur, Ur, Uu, Uh, Uu, Qxe, Chr, Rr^Vd, Ur, Ur, Uu^Tf, Ur, Ur, Uu^Tf, Ur, Uh, Rr, Rr, Ur, Ur, Chr, Ur, Chr, Ur, Uu, Qxe, Ur, Xu, Xu, Xu, Xu, Xu, Uu, Xu, Ur, Xu, Xu, Xu, Xu, Xu
Xu, Xu, Xu, Xu, Xu, Ql, Uu, Ur, Ur, Xu, Xu, Xu, Xu, Uu, Xu, Ur, Ur, Qxe, Chr, Chr, Ur, Rr, Rr, Ur, Ur, Qxe, Ur, Ur, Uh, Uh, Ur, Rr, Ur, Uu^Tf, Ur, Ur, Ur, Uu^Tf, Chr, Qxe, Uu, Uu, Xu, Xu, Xu, Uu, Uu, Ur, Uh, Xu, Xu, Xu, Xu
Xu, Xu, Xu, Xu, Xu, Xu, Xu, Uu^Tf, Uu, Xu, Xu, Xu, Xu, Uu^Tf, Xu, Uu^Tf, Ur, Qxe, Chr, Chr, Uu^Tf, Ur, Ur, Qxe, Rr, Ur, Qxe, Ur, Chr, Qxe, Rr, Rp^Vhcr, Rr, Ur, Ur, Qxe, Rr, Ur, Chr, Qxe, Uu, Uh, Xu, Xu, Xu, Uu, Xu, Uu, Uu, Uu, Xu, Xu, Xu
Xu, Xu, Xu, Xu, Xu, Xu, Xu, Uh, Uh, Xu, Xu, Xu, Xu, Xu, Xu, Ur, Qxe, Qxe, Re, Wwf, Chr, Ur, Uu^Tf, Ur, Rr, Ur, Rr, Qxe, Rr, Chr, Qxe, Ur, Ur, Rr, Rr, Rr, Ur, Rp^Vhcr, Chr, Qxe, Uu, Uh, Uu^Tf, Xu, Xu, Xu, Uh, Uu^Tf, Xu, Uu, Xu, Xu, Xu
Xu, Xu, Xu, Xu, Xu, Xu, Xu, Ur, Ur, Xu, Xu, Xu, Ql, Xu, Ql, Rd, Qxe, Re, Uu, Qxe, Qxe, Ur, Ur, Ur, Ur, Rp^Vhcr, Ur, Qxe, Chr, Chr, Chr, Qxe, Chr, Ur, Rr^Vd, Ur, Ur, Chr, Qxe, Qxe, Uu, Uh, Uu^Tf, Xu, Xu, Xu, Uh, Ur, Uu, Xu, Xu, Xu, Xu
Xu, Xu, Xu, Xu, Xu, Xu, Xu, Uu, Ur, Uu^Tf, Xu, Xu, Xu, Ql, Ql, Rd, Rd, Re, Ur, Uu, Uu, Uu, Qxe, Chr, Ur, Rr, Chr, Qxe, Qxe, 3 Khr, Chr, Chr, Qxe, Ur, Ur, Ur, Chr, Ur, Uu, Uu, Uu, Uh, Uu, Xu, Xu, Xu, Uu, Uh, Uh, Uu, Xu, Xu, Xu
Xu, Xu, Xu, Xu, Xu, Xu, Uu^Tf, Uh, Uu, Uu, Xu, Xu, Xu, Xu, Xu, Ql, Ql, Ql, Ql, Xu, Xu, Uu, Uu, Uu, Chr, Ur, Qxe, Ur, Ur, Chr, Ur, Ur, Uu^Tf, Qxe, Uh, Ur, Chr, Qxe, Uu, Uu, Uu, Uu, Xu, Uu, Uu, Uu, Xu, Uu, Uu, Uu, Xu, Xu, Xu
Xu, Xu, Xu, Xu, Xu, Xu, Uu^Tf, Ur, Uh, Xu, Ql, Ql, Ql, Xu, Xu, Xu, Xu, Xu, Ql, Xu, Xu, Uu, Uu, Qxe, Chr, Ur, Uu^Tf, Qxe, Ur, Chr, Chr, Ur, Ur, Qxe, Ur, Ur, Ur, Qxe, Uu, Uu, Xu, Xu, Xu, Uu, Uu, Xu, Uu, Uu, Xu, Xu, Xu, Xu, Xu
Xu, Xu, Xu, Xu, Xu, Xu, Uu, Ur, Uu, Uh, Ql, Ql, Xu, Xu, Xu, Xu, Xu, Xu, Ql, Xu, Uu^Tf, Uu, Uu, Qxe, Ur, Ur, Ur, Ur, Qxe, Ur, Rr, Ur, Qxe, Ur, Uu^Tf, Ur, Ur, Uu, Ur, Xu, Xu, Uu, Uu, Uu^Tf, Uu, Xu, Uu, Uu, Uu, Xu, Xu, Xu, Xu
Xu, Xu, Xu, Xu, Xu, Xu, Ur, Uu, Uu, Uu, Xu, Xu, Xu, Xu, Xu, Xu, Ql, Ql, Xu, Xu, Uu, Uu^Tf, Ur, Ur, Qxe, Chr, Chr, Ur, Rr^Vd, Rr, Ur, Qxe, Ur, Ur, Ur, Chr, Chr, Qxe, Uu, Xu, Uu, Xu, Uu, Uu, Uu, Xu, Uu, Uu^Tf, Xu, Xu, Xu, Xu, Xu
Xu, Xu, Xu, Xu, Ql, Uh, Ur, Uu, Uu^Tf, Uu^Tf, Xu, Xu, Xu, Xu, Xu, Xu, Ql, Ql, Xu, Xu, Uu, Uu, Uh, Uu, Uu, Qxe, Uu, Ur, Ur, Ur, Chr, Chr, Ur, Chr, Qxe, Qxe, Qxe, Qxe, Ur, Uu, Uu, Xu, Uu^Tf, Uu^Tf, Xu, Xu, Uu, Uu, Xu, Uu, Xu, Xu, Xu
Xu, Xu, Xu, Xu, Xu, Uu, Ur, Uu, Xu, Xu, Xu, Xu, Xu, Xu, Xu, Xu, Ql, Xu, Xu, Xu, Uu, Uu, Ur, Uu, Uu, Uu, Uu, Uu, Uu, Uh, Qxe, Qxe, Uu, Qxe, Uu, Uu, Uu^Tf, Uu, Uu, Uu, Ur, Uu, Uh, Uu, Uu, Uu, Uh, Xu, Ql, Ql, Xu, Xu, Xu
Xu, Xu, Xu, Xu, Xu, Uu^Tf, Ur, Ur, Xu, Xu, Xu, Xu, Xu, Xu, Xu, Ql, Ql, Xu, Xu, Uu, Uu^Tf, Uh, Uu, Uu, Uu, Uu, Uu^Tf, Uu^Tf, Uu, Uu, Uu, Uu, Uu, Uh, Ur, Uu, Uu^Tf, Uu^Tf, Xu, Xu, Xu, Ur, Uu, Uh, Uh, Uu, Ql, Ql, Xu, Ql, Ql, Xu, Xu
Ql, Xu, Xu, Xu, Uu^Tf, Uu, Ur, Ur, Uu^Tf, Xu, Ql, Xu, Xu, Xu, Xu, Xu, Ql, Uu, Uu, Uu^Tf, Uu, Ur, Uu^Tf, Uu^Tf, Xu, Uu, Uu, Uu, Uh, Xu, Uu, Uu, Uh, Uh, Uu, Ur, Uu, Uu, Xu, Xu, Uu, Uu, Ur, Uu, Xu, Ur, Ur, Ql, Ql, Xu, Xu, Xu, Xu
Xu, Ql, Xu, Xu, Uh, Uh, Uu, Uu, Xu, Xu, Ql, Ql, Xu, Xu, Xu, Xu, Ql, Xu, Xu, Uu, Uu, Uh, Uu, Uu, Xu, Uh, Uh, Uu^Tf, Uh, Xu, Xu, Uu, Uu, Uu^Tf, Uu^Tf, Uu, Xu, Ur, Uh, Xu, Ur, Xu, Ur, Ur, Xu, Xu, Ur, Xu, Xu, Xu, Xu, Xu, Xu
Ql, Ql, Xu, Xu, Uh, Uu, Ur, Uu, Uu, Uh, Uu, Ql, Xu, Xu, Xu, Xu, Ql, Ur, Uu, Ur, Uu, Uu, Uu, Uu^Tf, Xu, Xu, Uu, Uu^Tf, Xu, Xu, Xu, Uh, Uu, Uu, Uu, Uu, Xu, Uu, Uu^Vu, Uu, Uu, Ur, Xu, Ur, Uu, Ur, Uu, Uu, Xu, Xu, Xu, Xu, Xu
Ql, Xu, Xu, Xu, Xu, Uu, Uu, Ur, Ur, Uu, Ur, Ur, Uu, Xu, Xu, Ql, Uu, Uu, Xu, Uu, Ql, Uu, Uu, Uu, Xu, Uu, Uu, Uu^Tf, Uu, Uu, Xu, Xu, Xu, Xu, Xu, Xu, Xu, Ur, Xu, Uu^Tf, Xu, Xu, Uu^Tf, Uh, Uh, Uu, Uu^Tf, Xu, Xu, Xu, Xu, Xu, Xu
Ql, Xu, Xu, Xu, Ql, Uu, Ur, Uu, Xu, Uu, Xu, Uu, Uu, Ur, Uu, Ql, Ql, Uu, Uu, Ql, Ql, Uu, Xu, Xu, Xu, Xu, Uu, Uu, Xu, Xu, Xu, Xu, Xu, Xu, Ql, Xu, Xu, Xu, Xu, Xu, Ql, Xu, Xu, Uu, Uu, Uu, Uh, Xu, Ql, Ql, Xu, Xu, Xu
Xu, Ql, Ql, Ql, Xu, Uu^Tf, Ur, Uu, Xu, Xu, Uu^Tf, Xu, Uh, Ur, Ur, Uu, Uu, Uu, Uu, Ql, Ql, Xu, Xu, Xu, Xu, Xu, Ur, Xu, Xu, Xu, Xu, Xu, Ql, Ql, Xu, Ql, Uu, Uu, Uu, Ql, Ql, Xu, Xu, Uu^Tf, Ql, Uu, Uu, Uu, Xu, Ql, Xu, Xu, Xu
Xu, Xu, Xu, Xu, Uh, Ur, Uu, Uu, Xu, Xu, Xu, Uu, Uu, Uu, Ur, Ur, Ur, Ur, Ur, Uh, Xu, Xu, Xu, Xu, Ur, Ur, Xu, Xu, Xu, Xu, Xu, Xu, Ql, Xu, Xu, Uu, Uu, Uu, Ur, Ql, Xu, Xu, Xu, Ql, Ql, Ql, Xu, Ur, Xu, Xu, Xu, Xu, Xu
Xu, Xu, Xu, Uu^Tf, Uu, Ur, Uh, Xu, Xu, Uh, Uu^Tf, Uh, Uu, Ur, Uu, Uu^Vu, Xu, Uu, Uu^Tf, Uu, Ur, Uu, Uu^Tf, Xu, Uu, Xu, Xu, Xu, Xu, Xu, Xu, Xu, Ql, Xu, Xu, Xu, Xu, Xu, Xu, Xu, Uu^Tf, Xu, Xu, Xu, Xu, Xu, Xu, Xu, Ur, Xu, Xu, Xu, Xu
Xu, Xu, Ql, Xu, Uu, Uu, Xu, Xu, Xu, Uh, Uh, Uu, Ur, Uu, Xu, Xu, Xu, Xu, Xu, Uu, Ur, Ur, Ur, Uu, Uu, Xu, Xu, Xu, Xu, Xu, Ql, Xu, Ql, Xu, Uh, Uu, Uu, Uu, Uu, Uu, Uu, Xu, Xu, Xu, Xu, Xu, Rr^Vd, Uu, Ur, Uu, Wwf, Xu, Xu
Xu, Xu, Xu, Ql, Uu, Ur, Xu, Xu, Xu, Uu, Ur, Ur, Uu, Uu, Ql, Xu, Xu, Xu, Xu, Uh, Uu, Uu^Tf, Uh, Ur, Ur, Uu, Uu^Tf, Xu, Xu, Ql, Ql, Ql, Uu, Uu, Uh, Uu, Xu, Cud, Xu, Uh, Uu, Uu, Uu^Tf, Xu, Xu, Xu, Xu, Uu^Emf, Uu, Uu^Tf, Xu, Xu, Xu
Xu, Xu, Xu, Urb, Ql, Ql, Xu, Xu, Xu, Uu, Ur, Uu, Xu, Xu, Ql, Ql, Xu, Xu, Xu, Xu, Xu, Uu, Uh, Uh, Uu, Ur, Uu, Xu, Xu, Xu, Uu, Uu^Tf, Uu^Tf, Uu^Tf, Uu, Uu, Xu, Xu, Xu, Xu, Uu, Uh, Uu, Xu, Xu, Xu, Xu, Xu, Xu, Xu, Xu, Xu, Xu
Xu, Xu, Xu, Uu^Tf, Ur, Ql, Uu, Xu, Uh, Uu, Ur, Uh, Xu, Xu, Ql, Ql, Xu, Xu, Uu, Ur, Uu, Xu, Xu, Uu^Tf, Uu, Ur, Uh, Uh, Uu^Tf, Uu, Xu, Uu, Xu, Uu, Uu, Qxe, Qxe, Xu, Xu, Xu, Uh, Uu, Uu, Uu, Cud, Xu, Xu, Xu, Xu, Xu, Xu, Xu, Xu
Xu, Xu, Xu, Uh, Uu, Uu, Uu, Uu, Uu, Ur, Ur, Uu^Tf, Xu, Ql, Ql, Xu, Xu, Xu, Xu, Ur, Ur, Ur, Ur, Xu, Uh, Uu, Uu, Ur, Ur, Ur, Xu, Xu, Xu, Uh, Ur, Uu^Tf, Ur, Qxe, Uu, Uh, Uu, Uu, Ur, Cud, Cud, Cud, Xu, Xu, Xu, Xu, Xu, Xu, Xu
Xu, Xu, Xu, Uh, Uh, Ur, Uu, Xu, Xu, Uu, Uu, Uh, Uh, Xu, Ql, Xu, Xu, Xu, Xu, Xu, Xu, Uu, Xu, Xu, Xu, Xu, Xu, Uu, Uu^Tf, Uu, Uu, Uu, Uh, Uu, Uu^Tf, Uu, Xu, Uu, Uu, Uu, Cud, Cud, Cud, Ur, Uu, Uh, Rr^Vd, Xu, Xu, Xu, Xu, Xu, Xu
Xu, Xu, Xu, Uh, Xu, Uu, Ur, Xu, Xu, Xu, Uu, Ur, Xu, Xu, Ql, Ql, Xu, Xu, Xu, Xu, Xu, Xu, Uu, Ur, Uu, Uu, Uu, Xu, Xu, Xu, Xu, Uu, Ur, Uu, Xu, Xu, Uh, Xu, Uu, Xu, Xu, Cud, Uu, Ur, Ur, Uu, Uh, Xu, Uu^Tf, Xu, Xu, Xu, Xu
Xu, Xu, Xu, Xu, Uu, Uu, Uu, Xu, Xu, Uu^Tf, Uh, Ur, Uh, Xu, Ql, Xu, Xu, Xu, Xu, Xu, Xu, Ql, Ql, Ur, Ur, Uu, Xu, Xu, Xu, Xu, Xu, Uu^Tf, Ur, Xu, Ur, Ur, Uu, Uh, Ql, Ql, Xu, Xu, Rr^Vd, Uu, Uu, Ur, Ur, Uu, Uu, Uu^Tf, Xu, Xu, Xu
Xu, Xu, Xu, Xu, Uu, Ur, Xu, Xu, Xu, Xu, Xu, Ur, Uu, Ql, Xu, Xu, Xu, Xu, Xu, Xu, Xu, Xu, Xu, Ql, Xu, Xu, Xu, Xu, Xu, Xu, Ur, Ur, Xu, Ur, Xu, Uu^Tf, Ur, Ql, Xu, Ql, Ql, Xu, Xu, Uu^Tf, Uh, Uu, Cud, Cud, Cud, Uu, Xu, Xu, Xu
Xu, Xu, Xu, Uu^Tf, Ur, Uh, Xu, Ql, Xu, Xu, Xu, Ur, Uu, Xu, Xu, Xu, Uu^Tf, Uh, Xu, Xu, Xu, Xu, Xu, Xu, Xu, Xu, Xu, Xu, Xu, Xu, Ur, Xu, Xu, Uu, Xu, Xu, Ur, Xu, Xu, Ql, Xu, Xu, Xu, Uh, Uh, Uu, Cud, 1 Kud, Cud, Uu, Rr^Vd, Xu, Xu
Xu, Xu, Xu, Uu^Tf, Uu, Uh, Ql, Ql, Xu, Xu, Uh, Ur, Uu, Uu, Ur, Uu, Ur, Uu, Uh, Uu, Ur, Uu^Tf, Ur, Ur, Ur, Uu^Tf, Ur, Uu, Uh, Uu^Tf, Ur, Ur, Sm^Cov, Uu^Cov, Sm^Cov, Uu, Uu^Tf, Xu, Xu, Ql, Xu, Xu, Xu, Xu, Uu^Tf, Uu, Uu, Cud, Urb^Br\, Urb, Urb, Urb, Urb
Xu, Xu, Xu, Uh, Ur, Uu, Uu, Xu, Ur, Uu, Uu, Uu, Xu, Uu^Tf, Uu, Uu, Uh, Ur, Uu, Uh, Uu, Ur, Uu^Tf, Uu, Uh, Uu, Uh, Ur, Uu, Ur, Uu^Tf, Ur, Wwf^Cov, 5 Ss^Kov, Wwf^Cov, Uu, Xu, Xu, Xu, Xu, Xu, Xu, Xu, Xu, Xu, Uu^Tf, Rr^Vd, Uu, Urb, Urb^Br\, Urb^Br\, Urb, Urb
Xu, Xu, Ql, Uu, Xu, Uu, Xu, Uu, Xu, Uu, Xu, Xu, Xu, Xu, Xu, Uh, Xu, Uu, Xu, Xu, Xu, Xu, Xu, Xu, Xu, Uh, Xu, Xu, Xu, Xu, Xu, Xu, Xu, Sm^Cov, Xu, Xu, Xu, Xu, Xu, Xu, Xu, Xu, Xu, Xu, Xu, Xu, Xu, Uh, Uh, Urb, Urb, Urb^Br\, Urb^Br\
Ql, Ql, Xu, Xu, Xu, Xu, Xu, Xu, Xu, Xu, Xu, Xu, Xu, Xu, Xu, Xu, Xu, Xu, Xu, Xu, Xu, Xu, Xu, Xu, Xu, Xu, Xu, Xu, Xu, Xu, Xu, Xu, Xu, Xu, Xu, Xu, Xu, Xu, Xu, Xu, Xu, Xu, Xu, Xu, Xu, Xu, Xu, Xu, Xu, Xu, Xu, Urb, Urb
