border_size=1
usage=map

Iwr, Iwr, Iwr, Xue, Xue, Xue, Xue, Xue, Xue, Xue, Xue, Xue, Xue, Xue, Xue, Xue, Xue, Xue, Xue, Xue, Xue, Xue, Xue, Xue, Iwr, Iwr, Iwr, Xue, Xue, Xue, Xue, Xue, Xue, Xue, Xue, Xue, Xue, Xue, Xue, Xue, Xue, Xue, Xue, Xue, Xue, Xue
Iwr, Iwr, Iwr, Iwr, Xue, Xue, Re^Vct, Xue, Xue, Xue, Xue, Xue, Xue, Xue, Xue, Xue, Xue, Xue, Xue, Xue, Xue, Xue, Cud, Re^Vct, Iwr^Cov, Iwr^Cov, Iwr^Cov, Re^Vct, Cud, Xue, Xue, Xue, Xue, Xue, Xue, Xue, Xue, Xue, Xue, Xue, Xue, Xue, Xue, Xue, Iwr, Iwr
Iwr, Iwr, Iwr^Cov, Iwr^Cov, Iwr^Cov, Xue, Cud, Xue, Wwf, Wwf, Wwf, Wwf, Wwf, Wwf, Wwf, Wwf, Wwf, Wwf, Wwf, Xue, Xue, Xue, Cud, Iwr^Cov, Iwr^Cov, 5 Ket, Iwr^Cov, Iwr^Cov, Cud, Xue, Xue, Xue, Wwf, Xue, Wwf, Xue, Xue, Xue, Re^Vct, Xue, Xue, Xue, Iwr, Iwr, Iwr, Iwr
Xue, Iwr, Iwr^Cov, 6 Ket, Iwr^Cov, Iwr^Cov, Iwr, Cud, Wwf, Wwf, Gll^Fmf, Re, Gll^Fmf, Gll^Fmf, Gll^Fmf, Wwf, Rd, Wwf, Rd, Wwf, Wwf, Wwf, Wwf, Cud, Wwf, Iwr^Cov, Wwf, Cud, Wwf, Wwf, Wwf, Wwf, Gs^Ft, Wwf, Wwf, Wwf, Wwf, Xue, Cud, Cud, Iwr^Cov, Iwr, Iwr, Iwr, Iwr, Iwr
Xue, Xue, Re^Vct, Iwr^Cov, Cud, Iwr, Iwr, Cud, Wwf, Wwf, Gll^Fmf, Gll^Fmf, Gd^Fts, Re, Gd^Fts, Wwf, Re, Rd, Gll^Fmf, Rd, Gll^Fmf, Wwf, Wwf, Wwf, Wwf, Wwf, Wwf, Wwf, Wwf, Gs^Ft, Gs^Ft, Gs^Ft, Re, Gs^Ft, Re, Wwf, Wwf, Wwf, Cud, Iwr^Cov, 4 Ket, Iwr^Cov, Iwr, Iwr, Xue, Xue
Xue, Xue, Xue, Xue, Cud, Iwr, Wwf, Wwf, Wwf, Gll^Fmf, Gd^Fts, Gd^Fts, Gd^Fts, Gd^Fts, Dd, Rb, Gs^Ft, Re, Gd^Fts, Gd^Fts, Gd^Fts, Wwf, Gd^Fts, Gs^Ft, Gd^Fts, Wwf, Re, Gd^Fts, Wwf, Rd, Gll^Fmf, Rd, Gs^Ft, Gs^Ft, Gll^Fmf, Wwf, Gs^Ft, Wwf, Wwf, Iwr^Cov, Iwr^Cov, Iwr^Cov, Cud, Re^Vct, Xue, Xue
Xue, Xue, Wwf, Wwf, Wwf, Cud, Wwf, Wwf, Gd^Fts, Gs^Ft, Gs^Ft, Re, Rb, Gll^Fmf, Gd^Fts, Gd^Fts, Gs^Ft, Gd^Fts, Gd^Fts, Gd^Fts, Ds, Wwf, Re, Gs^Ft, Gll^Fmf, Re, Dd, Gll^Fmf, Gd^Fts, Gll^Fmf, Gll^Fmf, Ds, Ds, Dd, Gs^Ft, Ds, Wwf, Wwf, Wwf, Wwf, Cud, Cud, Wwf, Xue, Xue, Xue
Xue, Xue, Wwf, Wwf, Gd^Fts, Wwf, Wwf, Gd^Fts, Rb, Dd, Gs^Ft, Re, Gll^Fmf, Gll^Fmf, Gll^Fmf, Ds, Rb, Dd, Gd^Fts, Gd^Fts, Ds, Wwf, Wwf, Gll^Fmf, Gd^Fts, Re, Re, Gd^Fts, Re, Gd^Fts, Gd^Fts, Dd, Rd, Gd^Fts, Dd, Gd^Fts, Gd^Fts, Wwf, Wwf, Wwf, Wwf, Wwf, Wwf, Xue, Xue, Xue
Xue, Xue, Wwf, Wwf, Gd^Fts, Gd^Fts, Rb, Wwf, Gll^Fmf, Rd, Gll^Fmf, Gs^Ft, Gs^Ft, Ds, Gs^Ft, Gs^Ft, Ds, Gd^Fts, Ds, Rb, Rb, Gs^Ft, Wwf, Gd^Fts, Gd^Fts, Re, Gd^Fts, Re, Re, Ds, Dd, Gd^Fts, Rd, Gd^Fts, Gd^Fts, Gd^Fts, Re, Gll^Fmf, Gd^Fts, Gd^Fts, Gd^Fts, Wwf, Wwf, Xue, Xue, Xue
Xue, Xue, Wwf, Wwf, Gs^Ft, Gs^Ft, Dd, Wwf, Wwf, Gll^Fmf, Gd^Fts, Gd^Fts, Dd, Gs^Ft, Dd, Gll^Fmf, Gs^Ft, Gll^Fmf, Dd, Dd, Dd, Gs^Ft, Wwf, Rd, Rd, Dd, Dd, Gll^Fmf, Re, Gll^Fmf, Gll^Fmf, Ds, Gll^Fmf, Rd, Gll^Fmf, Rb, Rb, Gs^Ft, Gll^Fmf, Ds, Gd^Fts, Wwf, Wwf, Xue, Xue, Xue
Xue, Xue, Wwf, Gs^Ft, Gs^Ft, Gd^Fts, Re, Gd^Fts, Dd, Wwf, Wwf, Wwf, Wwf, Dd, Gd^Fts, Gd^Fts, Gs^Ft, Gll^Fmf, Gll^Fmf, Rd, Gs^Ft, Rd, Gll^Fmf, Wwf, Gll^Fmf, Gd^Fts, Dd, Re, Dd, Re, Dd, Dd, Gd^Fts, Gd^Fts, Dd, Gll^Fmf, Gd^Fts, Gd^Fts, Gd^Fts, Gd^Fts, Dd, Wwf, Wwf, Xue, Xue, Xue
Xue, Xue, Wwf, Rd, Rb, Gs^Ft, Gs^Ft, Ds, Gd^Fts, Gd^Fts, Rb, Gd^Fts, Gd^Fts, Wwf, Wwf, Re, Dd, Dd, Rd, Gs^Ft, Re, Gs^Ft, Wwf, Wwf, Re, Gll^Fmf, Gd^Fts, Gd^Fts, Gll^Fmf, Gs^Ft, Gs^Ft, Dd, Rb, Gll^Fmf, Gll^Fmf, Rd, Gd^Fts, Gd^Fts, Gd^Fts, Gd^Fts, Rd, Wwf, Wwf, Xue, Xue, Xue
Xue, Xue, Wwf, Rd, Gll^Fmf, Gll^Fmf, Gs^Ft, Gd^Fts, Gd^Fts, Dd, Re, Dd, Gs^Ft, Dd, Wwf, Gll^Fmf, Dd, Dd, Rd, Dd, Gd^Fts, Re, Wwf, Rd, Re, Gd^Fts, Rd, Gll^Fmf, Dd, Gs^Ft, Gd^Fts, Gs^Ft, Gs^Ft, Rb, Ds, Re, Re, Ds, Gll^Fmf, Gll^Fmf, Wwf, Wwf, Wwf, Xue, Xue, Xue
Xue, Xue, Wwf, Gll^Fmf, Rd, Gll^Fmf, Re, Gs^Ft, Gs^Ft, Gs^Ft, Gd^Fts, Dd, Gll^Fmf, Gs^Ft, Wwf, Ds, Dd, Gll^Fmf, Gll^Fmf, Gd^Fts, Gd^Fts, Gs^Ft, Dd, Wwf, Gd^Fts, Gd^Fts, Dd, Re, Gll^Fmf, Gll^Fmf, Rb, Re, Rd, Dd, Wwf, Dd, Wwf, Wwf, Wwf, Wwf, Dd, Gll^Fmw, Wwf, Xue, Xue, Xue
Xue, Xue, Wwf, Gll^Fmf, Wwf, Gd^Fts, Gd^Fts, Gd^Fts, Ds, Gd^Fts, Dd, Re, Ds, Gs^Ft, Wwf, Ds, Gd^Fts, Gs^Ft, Gs^Ft, Gd^Fts, Rd, Re, Rd, Wwf, Re, Dd, Dd, Re, Re, Gd^Fts, Gll^Fmf, Gd^Fts, Wwf, Wwf, Gs^Ft, Wwf, Gd^Fts, Gd^Fts, Re, Re, Rb, Gll^Fmf, Wwf, Xue, Xue, Xue
Xue, Xue, Wwf, Gll^Fmf, Wwf, Wwf, Gs^Ft, Gd^Fts, Rd, Dd, Dd, Gll^Fmf, Gll^Fmf, Re, Gll^Fmf, Wwf, Wwf, Gs^Ft, Rb, Rd, Re, Re, Wwf, Wwf, Wwf, Re, Dd, Gd^Fts, Gd^Fts, Dd, Re, Gll^Fmf, Wwf, Gd^Fts, Gd^Fts, Gs^Ft, Gs^Ft, Rd, Wwf, Wwf, Wwf, Wwf, Wwf, Xue, Xue, Xue
Xue, Xue, Wwf, Wwf, Ds, Ds, Gd^Fts, Gs^Ft, Gd^Fts, Rd, Gs^Ft, Gll^Fmf, Rd, Dd, Gd^Fts, Gll^Fmf, Re, Wwf, Gll^Fmf, Gll^Fmf, Gll^Fmf, Wwf, Wwg, Wwg, Wwg, Wwf, Rd, Dd, Rd, Re, Wwf, Wwf, Re, Gll^Fmf, Gll^Fmf, Gs^Ft, Gll^Fmf, Gd^Fts, Gll^Fmf, Gll^Fmf, Wwf, Wwf, Wwf, Xue, Xue, Xue
Xue, Xue, Wwf, Rb, Dd, Gd^Fts, Gs^Ft, Gll^Fmf, Gll^Fmf, Dd, Gs^Ft, Gs^Ft, Re, Re, Gd^Fts, Gll^Fmf, Rd, Wwf, Wwf, Wwf, Wwf, Wwf, Wwg, Wwg, Wwg, Wwf, Dd, Dd, Wwf, Wwf, Wwf, Wwf, Gll^Fmf, Rd, Ds, Rd, Gs^Ft, Gs^Ft, Rb, Gd^Fts, Wwf, Wwf, Wwf, Xue, Xue, Xue
Xue, Xue, Wwf, Rb, Dd, Re, Re, Gs^Ft, Re, Gd^Fts, Gll^Fmw, Dd, Gd^Fts, Dd, Rd, Gd^Fts, Rd, Re, Gs^Ft, Re, Dd, Wwf, Wwf, Wwg, Wwf, Wwf, Wwf, Wwf, Gd^Fts, Gd^Fts, Gd^Fts, Wwf, Gd^Fts, Rd, Gd^Fts, Dd, Dd, Gs^Ft, Gs^Ft, Wwf, Rb, Wwf, Wwf, Xue, Xue, Xue
Xue, Xue, Wwf, Gll^Fmf, Gs^Ft, Rb, Rb, Re, Gll^Fmf, Ds, Ds, Gd^Fts, Dd, Gd^Fts, Dd, Gd^Fts, Rd, Gd^Fts, Dd, Rd, Wwf, Wwf, Re, Wwf, Wwf, Re, Re, Dd, Dd, Dd, Rd, Wwf, Wwf, Gd^Fts, Re, Ds, Dd, Dd, Rb, Gs^Ft, Gs^Ft, Wwf, Wwf, Xue, Xue, Xue
Xue, Xue, Wwf, Wwf, Re, Gs^Ft, Re, Gll^Fmf, Gll^Fmf, Gll^Fmf, Rd, Rd, Ds, Rd, Gs^Ft, Gs^Ft, Rd, Gd^Fts, Gd^Fts, Dd, Wwf, Re, Re, Dd, Wwf, Gll^Fmf, Gll^Fmf, Re, Gs^Ft, Gs^Ft, Gll^Fmf, Gs^Ft, Wwf, Dd, Rb, Re, Gd^Fts, Ds, Gd^Fts, Gll^Fmf, Wwf, Wwf, Wwf, Xue, Xue, Xue
Xue, Xue, Wwf, Wwf, Gd^Fts, Gd^Fts, Gd^Fts, Gs^Ft, Dd, Rd, Gs^Ft, Dd, Gs^Ft, Re, Gs^Ft, Gs^Ft, Gll^Fmf, Re, Wwf, Wwf, Gll^Fmf, Gd^Fts, Gll^Fmf, Gd^Fts, Wwf, Gll^Fmf, Rd, Dd, Gll^Fmf, Gs^Ft, Gll^Fmf, Gd^Fts, Rb, Wwf, Dd, Gll^Fmf, Rd, Dd, Dd, Gll^Fmf, Gll^Fmf, Wwf, Wwf, Xue, Xue, Xue
Xue, Xue, Wwf, Rb, Gd^Fts, Gll^Fmf, Dd, Gs^Ft, Gs^Ft, Re, Re, Dd, Gs^Ft, Gs^Ft, Dd, Dd, Rb, Gll^Fmf, Wwf, Wwf, Rd, Dd, Gll^Fmf, Gll^Fmf, Wwf, Gd^Fts, Dd, Gd^Fts, Gd^Fts, Rd, Gd^Fts, Gs^Ft, Dd, Wwf, Rb, Rd, Dd, Dd, Gd^Fts, Re, Gll^Fmf, Wwf, Wwf, Xue, Xue, Xue
Xue, Xue, Wwf, Rb, Wwf, Re, Re, Gll^Fmf, Gll^Fmf, Dd, Rb, Gll^Fmf, Dd, Gll^Fmf, Rb, Ds, Wwf, Wwf, Rd, Dd, Dd, Re, Ds, Gs^Ft, Wwf, Dd, Gll^Fmf, Gll^Fmf, Dd, Gd^Fts, Dd, Gs^Ft, Gs^Ft, Wwf, Gs^Ft, Rb, Ds, Gd^Fts, Gs^Ft, Wwf, Wwf, Gll^Fmf, Wwf, Xue, Xue, Xue
Xue, Xue, Wwf, Wwf, Rb, Gd^Fts, Dd, Re, Rd, Gd^Fts, Gd^Fts, Rb, Re, Rb, Wwf, Wwf, Rd, Gll^Fmf, Gll^Fmf, Rd, Dd, Ds, Wwf, Wwf, Wwf, Re, Dd, Re, Re, Rd, Dd, Wwf, Wwf, Wwf, Rb, Rb, Wwf, Wwf, Wwf, Wwf, Rd, Gll^Fmf, Wwf, Xue, Xue, Xue
Xue, Xue, Wwf, Rd, Rb, Gd^Fts, Dd, Gd^Fts, Dd, Gd^Fts, Rd, Rd, Gs^Ft, Re, Wwf, Gs^Ft, Dd, Dd, Rd, Dd, Gd^Fts, Gll^Fmf, Rd, Wwf, Rd, Gll^Fmf, Gll^Fmf, Gll^Fmf, Re, Dd, Gll^Fmf, Wwf, Wwf, Wwf, Gll^Fmf, Gll^Fmf, Gll^Fmf, Wwf, Gs^Ft, Wwf, Wwf, Wwf, Wwf, Xue, Xue, Xue
Xue, Xue, Wwf, Dd, Re, Re, Gd^Fts, Gd^Fts, Dd, Gll^Fmf, Re, Gll^Fmf, Dd, Rd, Wwf, Gll^Fmf, Gs^Ft, Gs^Ft, Gs^Ft, Gs^Ft, Rd, Re, Re, Wwf, Dd, Re, Dd, Rb, Gd^Fts, Gll^Fmf, Gs^Ft, Gd^Fts, Gs^Ft, Wwf, Wwf, Dd, Rb, Gs^Ft, Gs^Ft, Gd^Fts, Gll^Fmf, Wwf, Wwf, Xue, Xue, Xue
Xue, Xue, Wwf, Gll^Fmf, Gll^Fmf, Gll^Fmf, Re, Gs^Ft, Gs^Ft, Gs^Ft, Rd, Gll^Fmf, Dd, Wwf, Wwf, Gll^Fmf, Gs^Ft, Gs^Ft, Rd, Gd^Fts, Gs^Ft, Dd, Rd, Wwf, Gs^Ft, Gs^Ft, Gd^Fts, Rb, Dd, Gll^Fmf, Dd, Re, Gs^Ft, Re, Gs^Ft, Wwf, Gd^Fts, Dd, Dd, Gs^Ft, Gd^Fts, Gll^Fmf, Wwf, Xue, Xue, Xue
Xue, Xue, Wwf, Wwf, Gll^Fmf, Rb, Ds, Dd, Gd^Fts, Gd^Fts, Gd^Fts, Wwf, Wwf, Wwf, Gs^Ft, Gs^Ft, Rd, Gd^Fts, Dd, Rd, Gs^Ft, Dd, Dd, Wwf, Gll^Fmf, Gs^Ft, Dd, Dd, Dd, Rb, Dd, Gs^Ft, Dd, Gd^Fts, Gd^Fts, Wwf, Wwf, Dd, Gd^Fts, Gll^Fmf, Ds, Wwf, Wwf, Xue, Xue, Xue
Xue, Xue, Xue, Wwf, Wwf, Gd^Fts, Gd^Fts, Ds, Gll^Fmf, Gll^Fmf, Gll^Fmf, Gll^Fmf, Wwf, Dd, Ds, Gll^Fmf, Gd^Fts, Rd, Re, Rd, Dd, Gd^Fts, Wwf, Wwf, Re, Gd^Fts, Gd^Fts, Dd, Rb, Gll^Fmf, Gs^Ft, Ds, Gll^Fmf, Dd, Rb, Gd^Fts, Gll^Fmf, Wwf, Ds, Gll^Fmf, Gll^Fmf, Wwf, Wwf, Xue, Xue, Xue
Xue, Xue, Xue, Wwf, Wwf, Gd^Fts, Dd, Re, Gd^Fts, Re, Wwf, Wwf, Gs^Ft, Re, Ds, Dd, Gd^Fts, Gd^Fts, Gd^Fts, Gd^Fts, Gd^Fts, Gd^Fts, Wwf, Re, Wwf, Gs^Fms, Rd, Gd^Fts, Gd^Fts, Gs^Ft, Dd, Rd, Gll^Fmf, Dd, Rb, Ds, Ds, Wwf, Wwf, Gll^Fmf, Wwf, Gll^Fmf, Wwf, Xue, Xue, Xue
Xue, Xue, Xue, Wwf, Wwf, Re, Gd^Fts, Gd^Fts, Wwf, Wwf, Rb, Rb, Gs^Ft, Gs^Ft, Gd^Fts, Gd^Fts, Gd^Fts, Gs^Ft, Gs^Ft, Wwf, Wwf, Wwf, Rb, Wwf, Wwf, Re, Rd, Gll^Fmf, Gll^Fmf, Gs^Ft, Gs^Ft, Gd^Fts, Dd, Gd^Fts, Ds, Ds, Rd, Rd, Wwf, Wwf, Cud, Wwf, Wwf, Xue, Xue, Xue
Xue, Xue, Cud, Cud, Cud, Wwf, Wwf, Wwf, Gll^Fmf, Gll^Fmf, Rd, Rb, Gs^Ft, Gd^Fts, Gd^Fts, Gll^Fmf, Re, Gll^Fmf, Wwf, Wwf, Rd, Wwf, Rd, Wwf, Rd, Ds, Gs^Ft, Gll^Fmf, Wwf, Rd, Gll^Fmf, Dd, Re, Re, Gll^Fmf, Rb, Wwf, Wwf, Cud, Iwr, Iwr, Cud, Cud, Xue, Xue, Xue
Xue, Re^Vct, Iwr^Cov, Iwr^Cov, Iwr^Cov, Wwf, Wwf, Gll^Fmf, Gll^Fmf, Gd^Fts, Gd^Fts, Wwf, Wwf, Re, Re, Gll^Fmf, Gll^Fmf, Re, Wwf, Wwf, Wwf, Wwf, Wwf, Wwf, Wwf, Wwf, Gll^Fmf, Gll^Fmf, Gll^Fmf, Wwf, Rb, Gs^Ft, Re, Gs^Ft, Wwf, Gs^Ft, Wwf, Wwf, Cud, Iwr, Iwr, Iwr, Iwr^Cov, Re^Vct, Xue, Xue
Iwr, Iwr, Iwr^Cov, 1 Ket, Iwr^Cov, Cud, Wwf, Wwf, Wwf, Wwf, Wwf, Wwf, Wwf, Wwf, Wwf, Wwf, Wwf, Wwf, Cud, Cud, Iwr^Cov, Cud, Cud, Wwf, Xue, Wwf, Wwf, Gll^Fmf, Gll^Fmf, Wwf, Wwf, Gd^Fts, Wwf, Gll^Fmf, Wwf, Wwf, Wwf, Wwf, Cud, Iwr, Iwr, Iwr, Iwr^Cov, Iwr, Iwr, Xue
Iwr, Iwr, Iwr, Iwr^Cov, Cud, Cud, Wwf, Wwf, Wwf, Xue, Xue, Xue, Xue, Wwf, Xue, Wwf, Xue, Xue, Cud, Iwr^Cov, 2 Ket, Iwr^Cov, Cud, Xue, Xue, Xue, Xue, Wwf, Wwf, Wwf, Wwf, Wwf, Wwf, Wwf, Xue, Wwf, Xue, Xue, Re^Vct, Iwr^Cov, Iwr^Cov, Iwr^Cov, 3 Ket, Iwr^Cov, Iwr, Xue
Iwr, Iwr, Iwr, Iwr, Re^Vct, Xue, Xue, Xue, Xue, Xue, Xue, Xue, Xue, Xue, Xue, Xue, Xue, Xue, Re^Vct, Iwr^Cov, Iwr^Cov, Iwr^Cov, Re^Vct, Xue, Xue, Xue, Xue, Xue, Xue, Xue, Xue, Xue, Xue, Xue, Xue, Xue, Xue, Xue, Xue, Xue, Xue, Iwr^Cov, Iwr^Cov, Iwr^Cov, Iwr, Iwr
Xuce, Xue, Xue, Xue, Xue, Xue, Xue, Xue, Xue, Xue, Xue, Xue, Xue, Xue, Xue, Xue, Xue, Xue, Xue, Iwr, Iwr, Iwr, Iwr, Xue, Xue, Xue, Xue, Xue, Xue, Xue, Xue, Xue, Xue, Xue, Xue, Xue, Xue, Xue, Xue, Xue, Xue, Xue, Xue, Iwr, Iwr, Iwr
