Xue, Xue, Xue, Xue, Xue, Xue, Xue, Xue, Xue, Xue, Xue, Xue, Xue, Xue, Xue, Xue, Xue, Xue, Xue, Xue, Xue, Xue, Xue, Xue, Xue, Xue, Xue, Xue, Xue, Xue, Xue, Xue, Xue, Xue, Xue, Xue, Xue, Xue, Xue, Xue, Xue, Xue, Xue, Xue, Xue, Xue, Xue, Xue, Xue, Xue, Xue, Xue
Xue, Qxua^Xo, Qxua^Xo, Qxua^Xo, Qxua^Xo, Qxua^Xo, Qxua^Xo, Qxua^Xo, Qxua^Xo, Qxua^Xo, Qxua^Xo, Qxua^Xo, Qxua^Xo, Qxua^Xo, Qxua^Xo, Qxua^Xo, Qxua^Xo, Qxua^Xo, Qxua^Xo, Qxua^Xo, Qxua^Xo, Qxua^Xo, Qxua^Xo, Qxua^Xo, Qxua^Xo, Qxua^Xo, Qxua^Xo, Qxua^Xo, Qxua^Xo, Qxua^Xo, Qxua^Xo, Qxua^Xo, Qxua^Xo, Qxua^Xo, Qxua^Xo, Qxua^Xo, Qxua^Xo, Qxua^Xo, Qxua^Xo, Qxua^Xo, Qxua^Xo, Qxua^Xo, Qxua^Xo, Qxua^Xo, Qxua^Xo, Qxua^Xo, Qxua^Xo, Qxua^Xo, Qxua^Xo, Qxua^Xo, Qxua^Xo, Xue
Xue, Qxua^Xo, Iwr, Iwr, Iwr, Iwr, Iwr, Iwr, Iwr, Iwr, Gg, Gg, Ww, Ww, Ww, Wo, Ww, Wo, Wo, Wo, Wo, Wo, Wo, Wo, Wo, Wo, Wo, Wo, Wo, Wo, Wo, Wo, Wo, Wo, Ww, Wo, Ww, Ww, Ww, Gg, Gg, Iwr, Iwr, Iwr, Iwr, Iwr, Iwr, Iwr, Iwr, Iwr, Qxua^Xo, Xue
Xue, Qxua^Xo, Iwr, Iwr, Iwr, Iwr, Iwr, Iwr, Iwr, Iwr, Gg, Ww, Ww, Ww^Ewf, Ww, Ww, Ww^Ewf, Ww, Ww, Ww, Ww, Wo, Ww, Wo, Wo, Wo, Wo, Wo, Ww, Wo, Ww, Ww, Ww, Ww, Ww^Ewf, Ww, Ww, Ww^Ewf, Ww, Ww, Gg, Iwr, Iwr, Iwr, Iwr, Iwr, Iwr, Iwr, Iwr, Iwr, Qxua^Xo, Xue
Xue, Qxua^Xo, Iwr, Iwr, Iwr, Iwr, Iwr, Iwr, Iwr, Iwr, Iwr, Gg, Gg, Ww, Wwr, Ww, Ww, Ww, Ww, Ww^Ewf, Ww, Ww, Ww^Ewf, Ww, Ww, Ww, Ww, Ww, Ww^Ewf, Ww, Ww, Ww^Ewf, Ww, Ww, Ww, Ww, Wwr, Ww, Gg, Gg, Iwr, Iwr, Iwr, Iwr, Iwr, Iwr, Iwr, Iwr, Iwr, Iwr, Qxua^Xo, Xue
Xue, Qxua^Xo, Iwr, Iwr, Iwr, Iwr, Iwr, Iwr, Iwr, Iwr, Iwr, Gg, Ch, Ch, Ch, Wwr, Ch, Wwr, Wwr, Ww, Wwr, Ww, Ww, Ww, Ww, Ww^Ewf, Ww, Ww, Ww, Ww, Wwr, Ww, Wwr, Wwr, Ch, Wwr, Ch, Ch, Ch, Gg, Iwr, Iwr, Iwr, Iwr, Iwr, Iwr, Iwr, Iwr, Iwr, Iwr, Qxua^Xo, Xue
Xue, Qxua^Xo, Iwr, Iwr, Iwr, Iwr, Iwr, Iwr, Iwr, Iwr, Iwr, Gg, Ch, Kh, Ch, Ch, Kh, Ch, Ch, Ch, Ch, Wwr, Ch, Wwr, Wwr, Ww, Wwr, Wwr, Ch, Wwr, Ch, Ch, Ch, Ch, Kh, Ch, Ch, Kh, Ch, Gg, Iwr, Iwr, Iwr, Iwr, Iwr, Iwr, Iwr, Iwr, Iwr, Iwr, Qxua^Xo, Xue
Xue, Qxua^Xo, Iwr, Iwr, Iwr, Iwr, Iwr, Iwr, Iwr, Iwr, Iwr, Gg, Gg, Ch, Gg, Ch, Ch, Ch, Ch, Kh, Ch, Ch, Kh, Ch, Ch, Ch, Ch, Ch, Kh, Ch, Ch, Kh, Ch, Ch, Ch, Ch, Gg, Ch, Gg, Gg, Iwr, Iwr, Iwr, Iwr, Iwr, Iwr, Iwr, Iwr, Iwr, Iwr, Qxua^Xo, Xue
Xue, Qxua^Xo, Iwr, Iwr, Iwr, Iwr, Iwr, Iwr, Iwr, Iwr, Iwr, Iwr, Gg, Gg^Fet, Gg, Gg, Gg^Fet, Gg, Gg, Ch, Gg, Ch, Ch, Ch, Ch, Kh, Ch, Ch, Ch, Ch, Gg, Ch, Gg, Gg, Gg^Fet, Gg, Gg, Gg^Fet, Gg, Iwr, Iwr, Iwr, Iwr, Iwr, Iwr, Iwr, Iwr, Iwr, Iwr, Iwr, Qxua^Xo, Xue
Xue, Qxua^Xo, Rrc, Iwr, Iwr, Iwr, Iwr, Iwr, Iwr, Iwr, Iwr, Iwr, Iwr, Gg, Iwr, Gg, Gg, Gg, Gg, Gg^Fet, Gg, Gg, Gg^Fet, Gg, Gg, Ch, Gg, Gg, Gg^Fet, Gg, Gg, Gg^Fet, Gg, Gg, Gg, Gg, Iwr, Gg, Iwr, Iwr, Iwr, Iwr, Iwr, Iwr, Iwr, Iwr, Iwr, Iwr, Iwr, Iwr, Qxua^Xo, Xue
Xue, Qxua^Xo, Rrc, Ce, Ce, Ce, Ce, Ce, Ce, Ce, Ce, Ce, Ce, Ce, Ce, Iwr, Iwr, Iwr, Iwr, Gg, Iwr, Gg, Gg, Gg, Gg, Gg^Fet, Gg, Gg, Gg, Gg, Iwr, Gg, Iwr, Iwr, Iwr, Iwr, Ce, Ce, Ce, Ce, Ce, Ce, Ce, Ce, Ce, Ce, Ce, Ce, Ce, Rrc, Qxua^Xo, Xue
Xue, Qxua^Xo, Rrc, Rrc, Rrc, Rrc, Rrc, Rrc, Rrc, Rrc, Rrc, Rrc, Rrc, Rrc, Rrc, Ce, Iwr, Iwr, Iwr, Iwr, Iwr, Iwr, Iwr, Iwr, Iwr, Gg, Iwr, Iwr, Iwr, Iwr, Iwr, Iwr, Iwr, Iwr, Iwr, Ce, Rrc, Rrc, Rrc, Rrc, Rrc, Rrc, Rrc, Rrc, Rrc, Rrc, Rrc, Rrc, Rrc, Rrc, Qxua^Xo, Xue
Xue, Qxua^Xo, Rrc, Rrc, Rrc, Rrc, Rrc, Rrc, Rrc, Rrc, Rrc, Rrc, Rrc, Rrc, Rrc, Ce, Iwr, Iwr, Iwr, Iwr, Iwr, Iwr, Rrc, Cud, Rrc, Iwr, Rrc, Cud, Rrc, Iwr, Iwr, Iwr, Iwr, Iwr, Iwr, Ce, Rrc, Rrc, Rrc, Rrc, Rrc, Rrc, Rrc, Rrc, Rrc, Rrc, Rrc, Rrc, Rrc, Rrc, Qxua^Xo, Xue
Xue, Qxua^Xo, Rrc, Rrc, Rrc, Rrc, Rrc, Rrc, Rrc, Rrc, Rrc, Rrc, Rrc, Rrc, Rrc, Ce, Iwr, Iwr, Cud, Iwr, Rrc, Rrc, Iwr, Iwr, Iwr, Rrc, Iwr, Iwr, Iwr, Rrc, Rrc, Iwr, Cud, Iwr, Iwr, Ce, Rrc, Rrc, Rrc, Rrc, Rrc, Rrc, Rrc, Rrc, Rrc, Rrc, Rrc, Rrc, Rrc, Rrc, Qxua^Xo, Xue
Xue, Qxua^Xo, Rrc, Rrc, Rrc, Rrc, Rrc, Rrc, Rrc, Rrc, Rrc, Rrc, Rrc, Rrc, Rrc, Ce, Rrc, Rrc, Rrc, Cud, Iwr, Iwr, Iwr, Iwr, Iwr, Iwr, Iwr, Iwr, Iwr, Iwr, Iwr, Cud, Rrc, Rrc, Rrc, Ce, Rrc, Rrc, Rrc, Rrc, Rrc, Rrc, Rrc, Rrc, Rrc, Rrc, Rrc, Rrc, Rrc, Rrc, Qxua^Xo, Xue
Xue, Qxua^Xo, Qxua, Qxua, Qxua, Qxua, Qxua, Qxua, Qxua, Qxua, Qxua, Qxua, Qxua, Qxua, Qxua, Qxua, Qxua, Qxua, Qxua, Qxua, Qxua, Qxua, Qxua, Qxua, Qxua, Qxua, Qxua, Qxua, Qxua, Qxua, Qxua, Qxua, Qxua, Qxua, Qxua, Qxua, Qxua, Qxua, Qxua, Qxua, Qxua, Qxua, Qxua, Qxua, Qxua, Qxua, Qxua, Qxua, Qxua, Qxua, Qxua^Xo, Xue
Xue, Qxua^Xo, Qxua^Xo, Qxua^Xo, Qxua^Xo, Qxua^Xo, Qxua^Xo, Qxua^Xo, Qxua^Xo, Qxua^Xo, Qxua^Xo, Qxua^Xo, Qxua^Xo, Qxua^Xo, Qxua^Xo, Qxua^Xo, Qxua^Xo, Qxua^Xo, Qxua^Xo, Qxua^Xo, Qxua^Xo, Qxua^Xo, Qxua^Xo, Qxua^Xo, Qxua^Xo, Qxua^Xo, Qxua^Xo, Qxua^Xo, Qxua^Xo, Qxua^Xo, Qxua^Xo, Qxua^Xo, Qxua^Xo, Qxua^Xo, Qxua^Xo, Qxua^Xo, Qxua^Xo, Qxua^Xo, Qxua^Xo, Qxua^Xo, Qxua^Xo, Qxua^Xo, Qxua^Xo, Qxua^Xo, Qxua^Xo, Qxua^Xo, Qxua^Xo, Qxua^Xo, Qxua^Xo, Qxua^Xo, Qxua^Xo, Xue
Xue, Qxua^Xo, Iwr, Iwr, Iwr, Iwr, Iwr, Iwr, Iwr, Iwr, Iwr, Iwr, Iwr, Iwr, Iwr, Iwr, Qxua, Qxua^Xo, Qxua, Iwr, Iwr, Iwr, Iwr, Iwr, Iwr, Iwr, Iwr, Iwr, Iwr, Iwr, Iwr, Iwr, Qxua, Qxua^Xo, Qxua, Iwr, Iwr, Iwr, Iwr, Iwr, Iwr, Iwr, Iwr, Iwr, Iwr, Iwr, Iwr, Iwr, Iwr, Iwr, Qxua^Xo, Xue
Xue, Qxua^Xo, Iwr, Iwr, Iwr, Iwr, Iwr, Iwr, Iwr, Iwr, Iwr, Iwr, Iwr, Iwr, Iwr, Iwr, Qxua, Qxua^Xo, Qxua, Iwr, Iwr, Iwr, Iwr, Iwr, Iwr, Iwr, Iwr, Iwr, Iwr, Iwr, Iwr, Iwr, Qxua, Qxua^Xo, Qxua, Iwr, Iwr, Iwr, Iwr, Iwr, Iwr, Iwr, Iwr, Iwr, Iwr, Iwr, Iwr, Iwr, Iwr, Iwr, Qxua^Xo, Xue
Xue, Qxua^Xo, Qxua^Xo, Qxua^Xo, Qxua^Xo, Qxua^Xo, Qxua^Xo, Qxua^Xo, Qxua^Xo, Qxua^Xo, Qxua^Xo, Qxua^Xo, Qxua^Xo, Qxua^Xo, Qxua^Xo, Qxua^Xo, Qxua^Xo, Qxua^Xo, Qxua^Xo, Qxua^Xo, Qxua^Xo, Qxua^Xo, Qxua^Xo, Qxua^Xo, Qxua^Xo, Qxua^Xo, Qxua^Xo, Qxua^Xo, Qxua^Xo, Qxua^Xo, Qxua^Xo, Qxua^Xo, Qxua^Xo, Qxua^Xo, Qxua^Xo, Qxua^Xo, Qxua^Xo, Qxua^Xo, Qxua^Xo, Qxua^Xo, Qxua^Xo, Qxua^Xo, Qxua^Xo, Qxua^Xo, Qxua^Xo, Qxua^Xo, Qxua^Xo, Qxua^Xo, Qxua^Xo, Qxua^Xo, Qxua^Xo, Xue
Xue, Qxua^Xo, Gd, Gd, Gll^Fdf, Gd, Hhd, Gd, Gd, Gd, Gd, Gd, Gd, Gd, Gll, Gd, Gd, Qxua^Xo, Aa^Fda, Aa, Ai, Aa, Aa, Aa, Aa, Aa, Aa^Fda, Aa, Aa, Aa, Aa, Aa, Aa^Fda, Qxua^Xo, Gll, Gd, Gd, Gd, Rb, Gd, Gd, Gd, Gd, Gd, Gd, Gd, Gd, Gd, Gd, Gd, Qxua^Xo, Xue
Xue, Qxua^Xo, Gd, Gll^Fdf, Gll^Fdf, Gd, Rb, Gll^Fdf, Gll^Fdf, Gll^Fdf, Gll^Fdf, Rb, Re, Gd, Gll, Gd, Gd, Qxua^Xo, Aa, Ai, Ai, Ai, Ai, Ms, Ai, Aa, Aa, Aa^Fda, Aa, Ai, Ai, Aa^Fda, Aa^Fda, Qxua^Xo, Gll, Gll, Gll^Fmf, Gll^Fmf, Re, Rb, Rb, Gd, Gll, Gd^Dr, Re, Gd, Rb, Rb, Gll^Fdf, Gd, Qxua^Xo, Xue
Xue, Qxua^Xo, Gd, Hhd, Gll^Fmf, Gll^Fdf, Hhd, Rb, Gll, Hhd, Gll, Re, Re, Re, Rb, Rb, Gd, Qxua^Xo, Ms, Ai, Aa, Aa, Aa, Ms, Ai, Ai, Aa, Aa, Aa, Ai, Ai, Aa, Aa, Qxua^Xo, Gd, Gll^Fmf, Re, Re, Gd^Dr, Gd^Dr, Gd^Dr, Gd, Gd, Gd, Gll^Fdf, Re, Rb, Rb, Gd, Gd, Qxua^Xo, Xue
Xue, Qxua^Xo, Gd, Gll^Fmf, Re, Gd, Gll^Fdf, Re, Re, Gll^Fdf, Gll^Fmf, Gd, Gd, Re, Rb, Gd, Gd, Qxua^Xo, Ms, Ai, Aa, Aa^Fpa, Ha, Ha, Ai, Aa, Aa, Aa^Fpa, Aa^Fpa, Aa, Ai, Aa^Fda, Aa, Qxua^Xo, Gd^Dr, Gd, Rb, Rb, Gd^Dr, Dd^Dc, Gll^Dr, Re, Gd, Gll^Fdf, Gll, Gll^Fmf, Gll^Fdf, Gll^Fdf, Gd, Gd, Qxua^Xo, Xue
Xue, Qxua^Xo, Gll^Fmf, Gll^Fmf, Rb, Gll^Fdf, Gll^Fmf, Gll, Gll, Gll^Fmf, Gll^Fdf, Gd, Gll, Rb, Gd, Gd, Gd, Qxua^Xo, Aa, Ai, Ai, Ha, Ms, Aa^Fpa, Aa^Fpa, Ai, Aa, Ha, Ha, Aa, Ai, Aa, Ha, Qxua^Xo, Gd, Gd, Gll^Fdf, Rb, Gll, Gll^Dr, Gd, Gd, Gll^Fdf, Gll^Fdf, Gd^Dr, Re, Gll^Fdf, Re, Gd, Gd, Qxua^Xo, Xue
Xue, Qxua^Xo, Gd, Gd, Gll^Fdf, Gll^Fmf, Re, Gll^Fmf, Gll, Rb, Gll, Re, Rb, Re, Re, Gd, Gd, Qxua^Xo, Aa^Fpa, Aa, Ai, Ha, Ai, Ai, Ai, Ai, Ai, Ms, Aa, Ai, Aa, Ms, Aa, Qxua^Xo, Gd, Re, Gll^Fdf, Re, Re, Gll, Gll, Gll^Fdf, Gd, Gll, Re, Re, Gd^Dr, Gd, Gd, Gd^Dr, Qxua^Xo, Xue
Xue, Qxua^Xo, Gd, Hhd, Gll^Fdf, Hhd, Gll^Fdf, Gll, Hhd, Gll^Fdf, Rb, Rb, Gll, Gll, Re, Gd, Gd, Qxua^Xo, Aa, Ms, Ms, Ai, Ai, Ai, Ai, Aa, Aa, Ai, Ai, Aa, Ha, Ha, Aa^Fpa, Qxua^Xo, Gd, Gll^Fmf, Gll^Fmf, Gll^Fmf, Gll, Gd^Dr, Gll, Gd, Gll^Fmf, Re, Re, Gd^Dr, Dd^Dc, Gd^Dr, Gd, Gd, Qxua^Xo, Xue
Xue, Qxua^Xo, Gll^Fmf, Gll^Fmf, Gll^Fmf, Gll^Fdf, Re, Re, Rb, Hhd, Re, Gll, Gll, Gll, Gll, Gd, Gd, Qxua^Xo, Aa, Ha, Aa^Fpa, Ai, Aa, Aa, Ai, Ai, Cea, Aa, Cea, Ai, Aa, Aa^Fpa, Aa, Qxua^Xo, Gd^Dr, Gll^Fdf, Gd, Re, Gd, Gd, Gll, Gll^Fmf, Gll, Gll, Gd, Gd^Dr, Gd^Dr, Gd^Dr, Chr, Chr, Qxua^Xo, Xue
Xue, Qxua^Xo, Hhd, Hhd, Gll^Fdf, Gll^Fdf, Gd, Gll, Gll^Fmf, Gd, Gll, Re, Rb, Rb, Rb, Gd, Gd, Qxua^Xo, Ha, Ha, Ai, Ai, Aa, Cea, Ai, Ai, Aa^Fpa, Cea, Aa, Ai, Cea, Aa^Fpa, Cea, Qxua^Xo, Gd, Gd, Chr, Gd, Gd^Dr, Gll^Dr, Gd^Dr, Gd, Chr, Gd^Dr, Gd, Gd, Chr, Gd, Chr, Rr, Qxua^Xo, Xue
Xue, Qxua^Xo, Re, Gll^Fdf, Gll^Fmf, Rb, Rb, Hhd, Hhd, Hhd, Re, Gd, Gd, Re, Re, Gd, Gd, Qxua^Xo, Aa, Ha, Ai, Cea, Aa, Aa, Ha, Ha, Ha, Aa^Fpa, Ai, Aa, Ha, Aa, Aa, Qxua^Xo, Chr, Chr, Rr, Chr, Chr, Dd^Dc, Chr, Gd, Rr, Chr, Rr, Chr, Rr, Chr, Rr, Rr, Qxua^Xo, Xue
Xue, Qxua^Xo, Gd, Gll^Fdf, Gll^Fmf, Gll^Fmf, Gd, Hhd, Gll^Fmf, Gll^Fmf, Rb, Re, Gll, Gll, Gll, Re, Gd, Qxua^Xo, Cea, Cea, Cea, Aa^Fpa, Ai, Ai, Ai, Ms, Aa, Aa^Fpa, Ha, Aa, Cea, Ha, Aa, Qxua^Xo, Rr, Rr, Rp^Dr, Rr, Rr, Chr, Rr, Rr, Rr, Rr, Rr, Chr, Rr, Rr, Rr, Rr, Qxua^Xo, Xue
Xue, Qxua^Xo, Gd, Gll^Fdf, Gll^Fmf, Gll^Fdf, Gll^Fdf, Gll, Re, Rb, Re, Rb, Re, Gd, Gll, Rb, Gd, Qxua^Xo, Aa, Aa, Ai, Ai, Aa, Cea, Re, Ai, Aa^Fpa, Aa^Fpa, Ha, Ha, Aa, Aa^Fpa, Aa^Fpa, Qxua^Xo, Rr, Rp^Dr, Rr, Rr, Rr, Rr, Gg, Gg, Gg, Rr, Rr, Rr, Rr, Rp^Dr, Rr, Rr, Qxua^Xo, Xue
Xue, Qxua^Xo, Gll, Rb, Gll^Fmf, Hhd, Gd, Gll^Fdf, Rb, Re, Hhd, Gll^Fmf, Gll, Rb, Rb, Rb, Gll, Qxua^Xo, Ha, Ms, Ai, Aa^Fpa, Ha, Ha, Ms, Re, Ai, Ai, Aa^Fpa, Ms, Ha, Aa^Fpa, Ha, Qxua^Xo, Rr, Rr, Rp^Dr, Rr, Rr, Rr, Gg, Gg^Fet, Gg, Rr, Rp^Dr, Rr, Rr, Rr, Rp^Dr, Rr, Qxua^Xo, Xue
Xue, Qxua^Xo, Gd, Gll^Fmf, Gd, Gd, Gd, Gll^Fdf, Gd, Gd, Hhd, Hhd, Gd, Gd, Gd, Re, Gd, Qxua^Xo, Aa^Fpa, Ha, Aa, Aa^Fpa, Aa, Ms, Aa, Re, Aa, Aa, Aa, Ha, Aa, Ms, Aa, Qxua^Xo, Rr, Rr, Rr, Rp^Dr, Rr, Rr, Rr, Gg, Rr, Rr, Rr, Rr, Rr, Rr, Rr, Rr, Qxua^Xo, Xue
Xue, Qxua^Xo, Qxua^Xo, Qxua^Xo, Qxua^Xo, Qxua^Xo, Qxua^Xo, Qxua^Xo, Qxua^Xo, Qxua^Xo, Qxua^Xo, Qxua^Xo, Qxua^Xo, Qxua^Xo, Qxua^Xo, Qxua^Xo, Qxua^Xo, Qxua^Xo, Qxua^Xo, Qxua^Xo, Qxua^Xo, Qxua^Xo, Qxua^Xo, Qxua^Xo, Qxua^Xo, Qxua^Xo, Qxua^Xo, Qxua^Xo, Qxua^Xo, Qxua^Xo, Qxua^Xo, Qxua^Xo, Qxua^Xo, Qxua^Xo, Qxua^Xo, Qxua^Xo, Qxua^Xo, Qxua^Xo, Qxua^Xo, Qxua^Xo, Qxua^Xo, Qxua^Xo, Qxua^Xo, Qxua^Xo, Qxua^Xo, Qxua^Xo, Qxua^Xo, Qxua^Xo, Qxua^Xo, Qxua^Xo, Qxua^Xo, Xue
Xue, Qxua^Xo, Hd, Dd, Dd, Dd, Rd, Rd, Hd, Dd, Rd, Dd, Dd, Dd, Dd, Dd, Dd, Qxua^Xo, Wwg, Gg, Gg, Gg, Gg, Gg, Gg, Gg, Gg, Gg, Gs^Fds, Gg, Gg, Gg, Gg, Qxua^Xo, Xoa, Xoa, Xoa, Xoa, Xoa^Efs, Iwr, Iwr, Iwr, Iwr, Xoa, Xoa, Xoa, Xoa^Efs, Xoa, Xoa, Xoa, Qxua^Xo, Xue
Xue, Qxua^Xo, Dd, Rb, Ds, Re, Gd, Ds, Gd, Dd, Gll, Dd, Ds, Rb, Re, Dd, Dd, Qxua^Xo, Gg, Wwg, Wwg, Gd, Gs^Fms, Gs^Fms, Gg, Gg, Gg, Gll, Gll, Gs^Fds, Gd, Gg, Gg, Qxua^Xo, Xoa, Xoa, Xoa, Xoa, Iwr, Iwr, Iwr, Iwr, Iwr, Xoa, Rr, Rr, Rr, Rr, Rr, Xoa, Qxua^Xo, Xue
Xue, Qxua^Xo, Dd, Rb, Rb, Re, Rd, Gd^Fts, Re, Gll, Gd^Fts, Rd, Dd, Rb, Ds, Dd, Dd, Qxua^Xo, Gs^Fms, Gg, Gs^Fds, Wwg, Gs^Fms, Gs^Fds, Wwg, Wwg, Wwg, Gg, Gg, Gll, Gs^Fms, Gd, Gg, Qxua^Xo, Xoa, Xoa, Xoa, Xoa, Iwr, Iwr, Iwr, Iwr, Iwr, Xoa^Efs, Xoa, Rr, Rr, Rr, Rr, Xoa, Qxua^Xo, Xue
Xue, Qxua^Xo, Hd, Dd, Gd^Fts, Rd, Gll, Rb, Wwg, Gll, Rd, Gd, Wwf, Re, Rd, Dd, Dd, Qxua^Xo, Gg, Gll, Gs^Fds, Wwg, Wwg, Wwg, Gg, Gg^Fet, Wwg, Gg, Gg, Gg, Gs^Fms, Gg, Gg, Qxua^Xo, Xoa, Xoa, Xoa, Xoa, Xoa, Iwr, Iwr, Iwr, Iwr, Iwr, Xoa^Efs, Rr, Rr, Rr, Xoa, Xoa, Qxua^Xo, Xue
Xue, Qxua^Xo, Dd, Dd, Gd, Gd^Fts, Wwf, Wwf, Wwg, Wwg, Wwg, Wwg, Hd, Ds, Ds, Dd, Dd, Qxua^Xo, Gg, Gg, Gg, Gll, Gll, Gg, Gd, Wwg, Gg, Gg, Gll^Fp, Gs^Fds, Gs^Fms, Gg, Gg, Qxua^Xo, Xoa, Xoa, Xoa, Xoa, Xoa^Efs, Iwr, Iwr, Iwr, Iwr, Iwr, Iwr, Xoa, Rr, Xoa^Efs, Xoa, Xoa, Qxua^Xo, Xue
Xue, Qxua^Xo, Dd, Gd, Rb, Re, Wwf, Wwg, Wwf, Gd^Fts, Rb, Wwf, Gd, Gd^Fts, Rd, Dd, Dd, Qxua^Xo, Gg, Gs^Fds, Gs^Fds, Gll^Fp, Gg, Gg, Gd, Wwg, Gg, Gg, Gll^Fp, Gg, Gll, Gg, Gg, Qxua^Xo, Xoa, Xoa, Xoa, Xoa, Iwr, Iwr, Iwr, Iwr, Iwr, Iwr, Iwr, Iwr, Iwr, Iwr, Xoa, Xoa, Qxua^Xo, Xue
Xue, Qxua^Xo, Dd, Rb, Rd, Rb, Gll, Wwf, Re, Gd^Fts, Rb, Gd^Fts, Rd, Rd, Rd, Dd, Dd, Qxua^Xo, Gg, Gg, Gg, Gll^Fp, Gll^Fp, Gg, Gs^Fms, Wwg, Gg, Gg, Gll^Fp, Gs^Fds, Gg, Gs^Fms, Gg, Qxua^Xo, Xoa, Xoa, Xoa, Xoa, Iwr, Iwr, Iwr, Iwr, Iwr, Iwr, Iwr, Iwr, Iwr, Iwr, Xoa, Xoa, Qxua^Xo, Xue
Xue, Qxua^Xo, Rd, Re, Re, Gd^Fts, Re, Re, Gll, Rd, Rb, Rd, Rd, Hd, Ds, Dd, Dd, Qxua^Xo, Gg, Gg, Gg, Gg, Gg, Gs^Fms, Gll^Fp, Wwg, Wwg, Gg, Gll^Fp, Gs^Fds, Gll, Gs^Fms, Gg, Qxua^Xo, Xoa, Xoa, Xoa^Efs, Xoa, Xoa^Efs, Iwr, Iwr, Iwr, Iwr, Iwr, Iwr, Iwr, Xoa^Efs, Iwr, Xoa, Xoa, Qxua^Xo, Xue
Xue, Qxua^Xo, Dd, Dd, Dd, Rb, Gd^Fts, Gll, Gd, Gd^Fts, Re, Dd, Rd, Ds, Hd, Hd, Dd, Qxua^Xo, Gg, Gll, Gs^Fms, Gg, Gg, Gg, Gg, Gll^Fp, Gll^Fp, Wwg, Gg, Gg, Gs^Fds, Gll, Gg, Qxua^Xo, Xoa, Xoa, Rr, Rr, Rr, Iwr, Iwr, Iwr, Iwr, Iwr, Rr, Xoa, Rr, Rr, Rr, Xoa, Qxua^Xo, Xue
Xue, Qxua^Xo, Hd, Re, Dd, Ds, Rd, Rd, Hd, Re, Dd, Ds, Ds, Ds, Dd^Do, Dd, Dd, Qxua^Xo, Gg, Gd, Gg, Gd, Gs^Fms, Gg, Gll, Gg, Gg, Wwg, Gll, Gs^Fds, Gll, Gll, Gg, Qxua^Xo, Xoa, Xoa, Rr, Rr, Rr, Xoa, Iwr, Iwr, Iwr, Iwr, Xoa, Rr, Rr, Rr, Rr, Xoa, Qxua^Xo, Xue
Xue, Qxua^Xo, Dd, Re, Re, Dd, Re, Hd, Re, Dd, Dd, Re, Re, Hd, Dd, Dd, Dd, Qxua^Xo, Gg, Gg, Gg, Gg, Gd, Gs^Fms, Gs^Fms, Gll, Wwg, Wwg, Gg, Gs^Fds, Gll, Gs^Fms, Gg, Qxua^Xo, Xoa, Xoa, Rr, Rr, Rr, Xoa, Iwr, Iwr, Iwr, Iwr, Xoa^Efs, Rr, Rr, Rr, Xoa, Xoa, Qxua^Xo, Xue
Xue, Qxua^Xo, Dd, Dd, Rd, Re, Re, Rd, Rd, Rd, Rd, Rd, Hd, Dd, Dd, Dd, Dd, Qxua^Xo, Gg, Gll, Gll^Fp, Gs^Fms, Gg, Gd, Wwg, Wwg, Gs^Fms, Gg, Gd, Gg, Gd, Gg, Gg, Qxua^Xo, Xoa, Xoa, Xoa, Rr, Xoa, Xoa, Iwr, Iwr, Iwr, Iwr, Xoa^Efs, Rr, Xoa, Xoa, Xoa, Xoa, Qxua^Xo, Xue
Xue, Qxua^Xo, Dd, Rd, Ds, Rd, Rd, Rd, Rd, Rd, Rd, Dd, Dd^Do, Ds, Ds, Re, Dd, Qxua^Xo, Gg, Gg, Gs^Fms, Gll^Fp, Gg, Wwg, Gg, Gg, Gg, Gs^Fms, Gs^Fms, Gg, Gs^Fms, Gg, Gg, Qxua^Xo, Xoa, Xoa, Xoa, Xoa, Xoa, Xoa, Iwr, Iwr, Iwr, Iwr, Iwr, Xoa, Xoa, Xoa, Xoa, Xoa, Qxua^Xo, Xue
Xue, Qxua^Xo, Hd, Dd, Rd, Rd, Dd, Re, Dd, 1 Dd, Rd, Dd, Dd, Dd, Rd, Re, Dd, Qxua^Xo, Gg, Gg, Gs^Fms, Gs^Fms, Gg, Wwg, Gs^Fms, Gs^Fms, Gs^Fms, Gd, Gg, Gs^Fms, Gll, Gg, Gg, Qxua^Xo, Xoa, Xoa, Xoa, Xoa, Xoa, Xoa, Iwr, Iwr, Iwr, Iwr, Iwr, Xoa, Xoa, Xoa, Xoa, Xoa, Qxua^Xo, Xue
Xue, Qxua^Xo, Hd, Hd, Dd, Dd, Dd, Re, Dd, Dd, Dd, Ds, Hd, Hd, Dd, Dd, Dd, Qxua^Xo, Gg, Gd, Gg, Gs^Fms, Wwg, Wwg, Gg, Gs^Fms, Gg, Gd, Gg, Gg, Gg, Gll, Gg, Qxua^Xo, Xoa, Xoa, Xoa, Xoa, Xoa, Xoa, Xoa, Iwr, Iwr, Iwr, Iwr, Xoa, Xoa, Xoa, Xoa, Xoa, Qxua^Xo, Xue
Xue, Qxua^Xo, Qxua^Xo, Qxua^Xo, Qxua^Xo, Qxua^Xo, Qxua^Xo, Qxua^Xo, Qxua^Xo, Qxua^Xo, Qxua^Xo, Qxua^Xo, Qxua^Xo, Qxua^Xo, Qxua^Xo, Qxua^Xo, Qxua^Xo, Qxua^Xo, Qxua^Xo, Qxua^Xo, Qxua^Xo, Qxua^Xo, Qxua^Xo, Qxua^Xo, Qxua^Xo, Qxua^Xo, Qxua^Xo, Qxua^Xo, Qxua^Xo, Qxua^Xo, Qxua^Xo, Qxua^Xo, Qxua^Xo, Qxua^Xo, Qxua^Xo, Qxua^Xo, Qxua^Xo, Qxua^Xo, Qxua^Xo, Qxua^Xo, Qxua^Xo, Qxua^Xo, Qxua^Xo, Qxua^Xo, Qxua^Xo, Qxua^Xo, Qxua^Xo, Qxua^Xo, Qxua^Xo, Qxua^Xo, Qxua^Xo, Xue
Xue, Xue, Xue, Xue, Xue, Xue, Xue, Xue, Xue, Xue, Xue, Xue, Xue, Xue, Xue, Xue, Xue, Xue, Xue, Xue, Xue, Xue, Xue, Xue, Xue, Xue, Xue, Xue, Xue, Xue, Xue, Xue, Xue, Xue, Xue, Xue, Xue, Xue, Xue, Xue, Xue, Xue, Xue, Xue, Xue, Xue, Xue, Xue, Xue, Xue, Xue, Xue
