Xue, Xue, Xue, Xue, Xue, Xue, Xue, Xue, Xue, Xue, Xue, Xue, Xue, Uue, Xue, Xue, Xue, Xue, Xue, Xue, Xue, Xue, Xue, Xue, Xue, Xue, Xue, Xue, Xue, Xue, Xue, Xue, Xue, Xue, Xue, Xue, Xue, Xue, Xue, Xue, Xue, Xue, Xue, Xue, Xue, Xue
Xue, Xue, Xue, Xue, Xue, Xue, Xue, Xue, Xue, Xue, Xue, Xue, Xue, Xue, Xue, Xue, Xue, Xue, Xue, Xue, Xue, Xue, Xue, Xue, Xue, Xue, Xue, Xue, Xue, Xue, Xue, Xue, Xue, Xue, Xue, Xue, Xue, Xue, Xue, Xue, Xue, Xue, Xue, Xue, Xue, Xue
Xue, Xue, Xue, Xue, Xue, Xue, Xue, Xue, Xue, Xue, Xue, Xue, Xue, Xue, Xue, Xue, Xue, Xue, Xue, Xue, Xue, Xue, Xue, Xue, Xue, Xue, Xue, Xue, Xue, Xue, Xue, Xue, Xue, Xue, Xue, Xue, Xue, Xue, Xue, Xue, Xue, Xue, Xue, Xue, Xue, Xue
Xue, Xue, Xue, Xue, Xue, Xue, Xue, Xue, Xue, Xue, Xue, Xue, Xue, Qxe, Ur, Xue, Xue, Xue, Xue, Xue, Xue, Xue, Xue, Xue, Xue, Xue, Xue, Xue, Xue, Xue, Xue, Xue, Xue, Xue, Xue, Xue, Xue, Xue, Xue, Xue, Xue, Xue, Xue, Xue, Xue, Xue
Xue, Xue, Xue, Xue, Xue, Xue, Xue, Xue, Uue, Xue, Qxe, Uue, Uu, Uu, Uu^Tf, Ur, Ur, Xue, Qxe, Xue, Xue, Xue, Xue, Xue, Xue, Xue, Xue, Xue, Xue, Xue, Xue, Xue, Xue, Xue, Xue, Xue, Xue, Xue, Xue, Xue, Xue, Xue, Xue, Xue, Xue, Xue
Xue, Xue, Xue, Xue, Xue, Xue, Uue, Xue, Ur, Uue, Ur, Ur, Ql, Uue, Xue, Ql, Uh, Ur, Uh, Xue, Xue, Xue, Xue, Xue, Xue, Xue, Xue, Xue, Xue, Xue, Xue, Xue, Xue, Xue, Xue, Uu^Tf, Ur, Xue, Uue, Xue, Xue, Xue, Qxe, Qxe, Qxe, Xue
Xue, Xue, Xue, Xue, Xue, Uu^Tf, Ur, Ur, Uh, Uu, Qxe, Qxe, Ql, Xue, Ql, Ql, Xue, Ur, Ur, Xue, Xue, Xue, Xue, Xue, Xue, Xue, Xue, Xue, Xue, Xue, Xue, Xue, Ur, Uu^Tf, Uue, Uu, Xue, Ur, Ur, Uu, Ur, Uh, Qxe, Ql, Ql, Xue
Xue, Xue, Xue, Xue, Qxe, Uu, Ur, Uh, Xue, Xue, Qlf, Qlf, Ql, Ql, Xue, Xue, Xue, Uh, Urb, Xue, Xue, Xue, Xue, Xue, Xue, Xue, Xue, Xue, Xue, Xue, Ur, Uu, Qxe, Ur, Qxe, Xue, Xue, Xue, Uu, Xue, Ur, Uh, Qxe, Ql, Qlf, Qlf
Xue, Xue, Xue, Xue, Uu^Tf, Ur, Uue, Qxe, Xue, Qlf, Qlf, Qlf, Ql, Xue, Xue, Xue, Urb, Uu^Tf, Uu, Uh, Urb, Xue, Urb, Urb, Uh, Xue, Xue, Xue, Uu^Tf, Urb, Qxe, Xue, Xue, Qxe, Xue, Xue, Qlf, Xue, Uh, Ur, Uu^Tf, Xue, Xue, Qlf, Qxe, Qlf
Xue, Xue, Xue, Uu^Tf, Ur, Ur, Uh, Xue, Xue, Xue, Xue, Xue, Xue, Ql, Xue, Xue, Urb, Uh, Uu, Uu^Tf, Uu, Urb, Urb, Urb, Urb, Urb, Uu, Urb, Uue, Urb, Urb, Xue, Xue, Xue, Xue, Qlf, Ql, Qxe, Ql, Ur, Ur, Xue, Qxe, Ql, Ql, Qlf
Xue, Xue, Xue, Ur, Uu, Xue, Xue, Xue, Qlf, Xue, Xue, Ql, Ql, Ql, Xue, Xue, Urb, Uh, Uu, Urb, Urb, Urb, Wwf^Qhu, Wwf^Qhu, Wwf^Qhu, Urb, Urb, Uu, Uue, Urb, Uh, Xue, Xue, Xue, Xue, Ql, Ql, Qxe, Qxe, Qxe, Qxe, Uue, Uu, Qxe, Ql, Ql
Xue, Xue, Uu, Uue, Xue, Xue, Qxe, Qlf, Qlf, Qlf, Xue, Xue, Xue, Xue, Uu^Tf, Urb, Uu^Tf, Uue, Urb, Urb, Wwf^Qhu, Wwf^Qhu, Wwrg, Wwrg, Wwrg, Wwf^Qhu, Wwf^Qhu, Urb, Uue, Uu^Tf, Urb, Xue, Xue, Xue, Xue, Qlf, Qlf, Ql, Ql, Qlf, Ql, Uh, Ur, Ur, Xue, Xue
Xue, Xue, Xue, Uu, Uue, Xue, Qxe, Ql, Ql, Ql, Qxe, Xue, Xue, Urb, Uh, Uu, Urb, Uh, Urb, Urb, Wwf^Qhu, Wwrg, Wwg^Cov, Wwg^Cov, Wwg^Cov, Wwrg, Wwf^Qhu, Urb, Urb, Uh, Urb, Xue, Xue, Xue, Xue, Xue, Xue, Xue, Xue, Ql, Xue, Uu^Tf, Uu, Ur, Uue, Xue
Xue, Xue, Xue, Ur, Ur, Xue, Ur, Uh, Ur, Uh, Qxe, Xue, Ur, Ur, Ur, Ur, Urb, Uu, Urb, Urb, Wwf^Qhu, Wwrg, Wwg^Cov, 2 Wog^Kov, Wwg^Cov, Wwrg^_ml, Wwf^Qhu, Urb, Urb, Uh, Uu^Tf, Urb, Urb, Xue, Xue, Xue, Ql, Qlf, Ql, Xue, Ql, Xue, Uu, Ur, Uue, Xue
Xue, Xue, Xue, Xue, Xue, Uu^Tf, Uu, Uu, Xue, Ur, Uu, Ur, Xue, Urb, Uue, Uu^Tf, Uh, Urb, Uue, Urb, Wwf^Qhu, Wwrg, Wwrg, Wwg^Cov, Wwrg, Wwrg, Wwf^Qhu, Urb, Ur, Uh, Uu^Tf, Uh, Ur, Xue, Ur, Xue, Xue, Ql, Qxe, Ql, Xue, Xue, Uue, Uh, Ur, Xue
Xue, Xue, Xue, Xue, Xue, Ur, Ur, Xue, Xue, Xue, Ur, Xue, Xue, Xue, Xue, Urb, Uh, Uu^Tf, Urb, Urb, Urb, Wwf^Qhu, Wwf^Qhu, Wwrg, Wwf^Qhu, Wwf^Qhu, Urb, Urb, Uu, Ur, Uu, Uu^Tf, Urb, Ur, Xue, Uu, Uu, Uh, Uh, Qxe, Xue, Xue, Uue, Uu, Xue, Xue
Xue, Xue, Xue, Xue, Xue, Wwf, Wwg, Xue, Uu^Vu, Uh, Uu, Uu^Uf, Xue, Xue, Xue, Urb, Uh, Uue, Ur, Uue, Urb, Urb, Urb, Wwf^Qhu, Urb, Ur, Ur, Ur, Ur, Uh, Urb, Urb, Xue, Xue, Xue, Xue, Xue, Ur, Xue, Uu, Ur, Uu^Tf, Ur, Uu, Xue, Xue
Xue, Xue, Xue, Xue, Xue, Wwg, Wwg, Xue, Uu, Ur, Uu, Uh, Xue, Xue, Uue, Uue, Ur, Ur, Uue, Uu, Uu, Urb, 1 Urb, Urb, Uue, Urb, Uu, Uu^Tf, Uu^Tf, Urb, Xue, Uu, Uu, Xue, Uh, Uu^Tf, Uu, Xue, Xue, Xue, Uu^Vu, Ur, Xue, Xue, Xue, Xue
Xue, Xue, Xue, Xue, Xue, Uu^Tf, Uh, Wwf, Wwg, Ur, Xue, Xue, Uh, Uu, Ur, Ur, Uu, Uu^Tf, Urb, Uh, Uh, Uu, Uue, Uue, Urb, Uu, Uh, Uue, Uue, Urb, Xue, Xue, Xue, Ur, Uu, Ur, Qxe, Uu, Xue, Xue, Ur, Uh, Xue, Xue, Xue, Xue
Xue, Xue, Xue, Xue, Uu^Tf, Uue, Ur, Ur, Ur, Uh, Ur, Ur, Ur, Ur, Qxe, Uu, Xue, Uu^Tf, Xue, Xue, Xue, Urb, Urb, Urb, Xue, Uu^Tf, Urb, Uh, Urb, Ur, Ur, Xue, Xue, Xue, Xue, Xue, Xue, Ur, Uu, Ur, Xue, Xue, Xue, Xue, Xue, Xue
Xue, Xue, Xue, Xue, Uue, Chr, Chr, Uu, Uu, Uu, Uh, Uu, Uu^Tf, Uu, Xue, Xue, Xue, Xue, Xue, Xue, Qxe, Uue, Uu, Qxe, Xue, Xue, Xue, Urb, Xue, Xue, Xue, Ur, Ur, Xue, Ur, Xue, Xue, Xue, Uh, Ur, Uh, Xue, Xue, Xue, Xue, Xue
Xue, Xue, Xue, Uu^Vu, Chr, Khr, Uu, Chr, Uh, Ur, Xue, Xue, Xue, Xue, Xue, Xue, Xue, Xue, Xue, Xue, Xue, Qxe, Uu, Qxe, Qxe, Xue, Xue, Xue, Xue, Xue, Xue, Uh, Xue, Ur, Xue, Ur, Ur, Uue, Uue, Ur, Chr, Uue, Uue, Xue, Xue, Xue
Xue, Xue, Xue, Uh, Uue, Uu^Tf, Uu^Vu, Uh, Xue, Xue, Xue, Xue, Xue, Xue, Xue, Xue, Xue, Xue, Xue, Xue, Qxe, Qxe, Uue, Urb, Qxe, Qxe, Xue, Xue, Xue, Xue, Xue, Xue, Xue, Xue, Xue, Xue, Xue, Xue, Wwg, Uu, Khr, Chr, Wwg, Uu^Vu, Xue, Xue
Xue, Xue, Xue, Xue, Xue, Xue, Xue, Xue, Xue, Xue, Xue, Xue, Xue, Xue, Xue, Xue, Xue, Xue, Xue, Xue, Qxe, Urb, Uue, Uu, Qxe, Qxe, Xue, Xue, Xue, Xue, Xue, Xue, Xue, Xue, Xue, Xue, Xue, Uu^Tf, Uu, Uu, Chr, Uu, Wwg, Xue, Xue, Xue
Xue, Xue, Xue, Xue, Xue, Xue, Xue, Xue, Xue, Xue, Xue, Xue, Xue, Xue, Xue, Xue, Xue, Xue, Xue, Xue, Qxe, Qxe, Urb, Qxe, Qxe, Xue, Xue, Xue, Xue, Xue, Xue, Xue, Xue, Xue, Xue, Xue, Xue, Uue, Wwg, Chr, Ur, Uu, Wwg, Xue, Xue, Xue
Xue, Xue, Xue, Xue, Xue, Xue, Xue, Xue, Xue, Xue, Xue, Xue, Xue, Xue, Xue, Xue, Xue, Xue, Xue, Xue, Qxe, Uue, Uu, Qxe, Qxe, Xue, Xue, Xue, Xue, Xue, Xue, Xue, Xue, Xue, Xue, Xue, Xue, Xue, Xue, Uu^Vu, Xue, Ur, Xue, Xue, Xue, Xue
Xue, Xue, Xue, Xue, Xue, Xue, Xue, Xue, Xue, Xue, Xue, Xue, Xue, Xue, Xue, Xue, Xue, Xue, Xue, Xue, Qxe, Qxe, Urb, Urb, Qxe, Xue, Xue, Xue, Xue, Xue, Xue, Xue, Xue, Xue, Xue, Xue, Xue, Xue, Xue, Xue, Xue, Xue, Xue, Xue, Xue, Xue
Xue, Xue, Xue, Xue, Xue, Xue, Xue, Xue, Xue, Xue, Xue, Xue, Xue, Xue, Xue, Xue, Xue, Xue, Xue, Xue, Qxe, Uue, Ur, Qxe, Qxe, Xue, Xue, Xue, Xue, Xue, Xue, Xue, Xue, Xue, Xue, Xue, Xue, Xue, Xue, Xue, Xue, Xue, Xue, Xue, Xue, Xue
