Rd, Rd, Dd, Hhd, Mm, Md, Md^Xm, Md, Md, Dd, Md^Xm, Md, Md, Md, Md, Md^Xm, Md^Xm, Dd, Hhd, Rd, Dd, Dd, Md, Md, Md^Xm, Md^Xm, Md^Xm, Md^Xm, Md^Xm, Md^Xm, Md, Md, Hd, Dd, Rd, Dd, Hd
Hd, Rd, Rd, Hhd, Hd, Md, Md^Xm, Md^Xm, Md^Xm, Md, Md^Xm, Md^Xm, Md^Xm, Md, Md, Md^Xm, Md, Md, Ce, Rd, Dd^Vdt, Hhd, Md, Md, Md, Md, Md, Md, Md^Xm, Md^Xm, Md, Md, Rd, Hd, Rd, Hd, Md
Md, Hd, Rd, Hd, Ce, Dd, Hd, Md^Xm, Hhd, Md, Md, Md, Md^Xm, Md^Xm, Hhd^Vhhr, Md, Hd, Ce, 4 Ke, Ce, Hd, Md, Md, Hhd, Md, Md, Md, Md, Hhd, Hhd, Ce, Rd, Dd, Rd, Hd, Md, Md
Md, Hd, Dd^Vdt, Ce, 3 Ke, Ce, Ce, Hhd, Dd^Vdt, Hhd, Hd, Md, Md, Md^Xm, Md, Hd, Dd, Ce, Ce, Ce, Hd, Md, Hhd^Vhhr, Hhd, Md, Hhd, Hd, Hd, Ce, Ce, 5 Ke, Ce, Ce, Hd, Md, Md, Md
Md^Xm, Md^Xm, Hhd, Ce, Ce, Ce, Dd, Hd, Ds, Dd, Hd, Md, Md, Md, Md, Hhd, Hd, Ce, Rd, Ce, Dd, Hd, Hd, Hhd, Hhd, Md, Hhd, Hd, Rd, Ce, Ce, Ce, Dd, Hd, Md, Md, Hhd
Md^Xm, Md, Hhd, Ce, Rd, Hd, Hd^Ecf, Rd, Hd, Dd^Vdt, Rd, Hd, Md, Md, Hhd, Hd, Hd, Dd^Vdt, Hd, Rd, Hd, Dd, Ds, Hd, Hd, Hhd, Hd, Hd, Rd, Dd, Hd, Rd, Rd, Dd, Hd, Md, Md
Md^Xm, Md^Xm, Hhd, Rd, Rd, Dd, Dd, Dd, Rd, Dd, Hd, Hd, Md, Md, Hd, Hd, Hd, Dd, Dd, Rd^Ecf, Dd, Dd, Rd, Dd, Hd, Dd^Vdt, Dd, Dd, Rd, Dd, Dd^Ecf, Hd, Rd, Dd, Re^Vct, Md, Md
Md, Md^Xm, Hd, Dd^Vdt, Dd, Rd, Rd, Rd, Dd, Dd, Dd, Hd, Hhd, Hhd, Hd, Dd, Dd, Dd, Dd, Dd, Dd, Rd, Rd, Dd, Rd, Hd, Dd, Rd, Dd^Vdt, Dd, Dd, Dd, Dd, Hd, Dd, Hd, Md
Md, Hd, Hd, Hd, Dd, Dd, Rd, Dd, Dd, Ds, Dd, Hd, Hd, Hhd, Hd, Dd, Dd, Dd, Dd, Dd, Dd, Dd, Hd, Dd, Dd, Dd, Dd, Rd, Rd, Dd, Dd, Dd, Re^Vct, Dd, Hd, Hd, Md
Md, Md^Xm, Hhd, Hd, Hd, Hd, Rd, Hd, Hd, Hd, Dd, Ds, Ds, Hd, Ds, Dd, Hd, Hd, Rd, Hd, Rd, Hd, Rd, Dd, Dd, Ds, Dd, Dd, Dd, Rd, Rd, Rd, Dd, Rd, Hd, Md, Md^Xm
Md^Xm, Md, Md, Dd, Dd, Dd, Rd, Dd, Dd, Hd, Dd, Dd, Dd, Hd, Dd, Dd, Dd, Rd, Hd, Dd, Dd, Dd, Hd, Dd, Hd, Dd, Rd, Rd, Rd, Dd, Rd, Dd, Dd, Dd, Hhd, Md, Md
Md^Xm, Md^Xm, Dd^Ftd, Dd^Ftd, Hd, Dd, Rd, Rd, Rd, Dd, Hd, Ds, Hd, Dd, Hd, Dd, Hd, Rd, Rd, Dd, Hd, Dd, Dd, Rd, Hd, Rd, Dd, Dd, Hd, Rd, Rd, Rd, Hd, Hd, Hhd, Md, Hhd
Md, Md^Xm, Md, Gd^Fts, Gs, Rd, Gd, Hd, Hd, Rd, Rd, Hd, Hd, Hd, Dd, Dd, Dd, Hd, Rd, Hd, Dd, Dd, Dd, Hd, Hd, Dd, Hd, Dd, Hd, Dd, Dd, Hd, Dd, Hd, Md, Md, Md^Xm
Md^Xm, Md, Md, Gd^Fts, Wwt, Wwt, Wwt, Gs, Dd^Ftd, Dd^Ftd, Dd, Rd, Dd, Ds, Dd, Rd, Dd, Rd, Dd, Dd, Hd, Dd, Dd, Hd, Hd, Dd, Hd, Dd, Rd, Hd, Dd, Dd, Hhd, Md, Md, Md^Xm, Md^Xm
Md^Xm, Md, Md, Md, Md, Gd, Gs, Wwt, Wwt, Hd, Ds, Rd, Rd, Dd, Hd, Dd, Hd, Rd, Rd, Ds, Dd, Rd, Rd, Dd, Hd, Dd, Rd, Rd, Rd, Hd, Hd, Hd, Md, Md, Md^Xm, Md^Xm, Md
Md^Xm, Md, Md, Md, Md, Hhd, Gd^Fts, Gd^Fts, Wwt, Hd, Hd, Gd^Fts, Rd, Hd, Rd, Ds, Dd, Dd, Rd, Dd, Dd, Ds, Dd, Ds, Rd, Hd, Ds, Ds, Dd, Hd, Hd, Md, Md, Md, Md^Xm, Md^Xm, Md^Xm
Md^Xm, Md, Md, Md, Md, Md, Hhd, Gd^Fts, Gs, Wwt, Dd^Ftd, Gd, Gd^Fts, Gd^Fts, Rd, Dd^Ftd, Dd, Dd, Dd, Rd, Dd, Dd, Rd, Rd, Dd^Ftd, Rd, Rd, Dd, Dd, Hd, Md, Md, Md, Md, Md^Xm, Md^Xm, Md^Xm
Md^Xm, Md^Xm, Md, Md, Md, Md, Md, Hhd, Hhd, Wwt, Wwt, Ds, Gs, Gs, Dd^Ftd, Dd, Hd, Dd, Ds, Rd, Hd, Dd, Rd, Hd, Dd^Do, Dd^Ftd, Dd, Hd, Dd, Rd, Hd, Md, Md, Md, Md, Md^Xm, Md^Xm
Md^Xm, Md^Xm, Md^Xm, Md, Hhd, Hhd, Hhd, Hhd, Dd^Do, Hhd, Gd, Wwt, Wwt, Hhd, Gd^Fts, Dd, Dd^Ftd, Hd, Hd, Rd, Hd, Dd, Dd^Ftd, Dd^Ftd, Rd, Dd^Ftd, Dd^Ftd, Dd^Ftd, Hd, Rd, Hd, Md, Md, Md, Md, Md^Xm, Md
Md^Xm, Md, Md, Hd, Hd, Hd, Rd, Rd, Gd, Gs, Wwt, Wwf, Wwt, Hhd, Gs, Gd^Fts, Dd^Ftd, Dd^Ftd, Dd, Rd, Rd, Rd, Rd, Rd, Hd, Rd, Hd, Hd, Rd, Hd, Hd, Md, Md, Md, Md, Md, Hhd
Md, Md, Md, Md, Hd, Dd, Gd^Fts, Gd^Fts, Gs, Wwt, Ds, Wwt, Gd, Gs^Ftp, Gd, Gd, Gd^Fts, Hd, Dd^Ftd, Hd, Dd^Ftd, Hd, Dd^Ftd, Dd^Ftd, Dd^Ftd, Hd, Dd^Ftd, Rd, Dd^Ftd, Dd^Ftd, Hd, Dd^Ftd, Md, Md, Md, Md, Hd
Md, Md, Md, Hd, Hd, Ds, Gd, Gd^Fts, Gd^Fts, Wwt, Wwt, Dd^Ftd, Hd, Gd^Fts, Hd, Rd, Rd, Rd, Dd, Rd, Rd, Rd, Dd^Ftd, Hd, Wwt, Dd^Ftd, Ds, Rd, Rd, Rd, Hd, Rd, Md, Md, Md, Md, Md
Md^Xm, Md^Xm, Md, Hd, Dd, Hd, Rd, Gs^Ftp, Gd, Gd^Fts, Wwt, Dd^Ftd, Dd^Ftd, Dd^Ftd, Rd, Rd, Gd, Hd, Gd, Gs, Rd, Hd, Gd, Wwt, Gs, Wwt, Wwt, Hd, Dd, Dd, Rd, Dd, Md, Md, Md, Md, Md
Md, Md, Hhd, Hd, Hd, Hd, Hhd, Hhd, Hhd, Hhd, Gs, Wwt, Wwt, Rd, Hd, Dd, Dd^Ftd, Dd^Ftd, Gs, Ds, Rd, Hd, Hd, Dd^Ftd, Gs, Hd, Wwt, Hd, Hd, Dd^Do, Dd, Hd, Dd^Ftd, Wwt, Md, Md, Md
Md, Md, Hd, Hd, Dd^Ftd, Dd, Ds, Dd, Rd, Gd, Gd, Gd^Fts, Wwt, Ds, Hd, Hd, Hd, Ds^Dr, Hd, Hd, Rd, Ds, Gd, Hd, Wwt, Wwt, Hd, Wwt, Dd^Ftd, Dd^Ftd, Dd, Hd, Wwt, Wwt, Hhd, Md, Md
Md, Md, Hd, Hd, Dd, Dd^Do, Dd, Dd^Ftd, Ds, Rd, Gd, Gd^Fts, Wwt, Hd, Cdr^Dr, Cdr, Rd, Rd, Rd, Cdr, Rd, Ds, Wwf, Wot, Wot, Hd, Wwt, Wwt, Ds, Dd, Wwt, Wwt, Wwt, Hd, Hd, Md, Md^Xm
Md^Xm, Md^Xm, Md, Dd^Ftd, Hd, Ds, Hd, Hd, Rd, Gd^Fts, Wwt, Wwt, Hd, Wwt, Wwf, Wwt, Wwt, Wwt, Wwf, Gs, Wwt, Wwt, Gd, Gs, Ds, Dd, Wwt, Dd^Ftd, Wwt, Hd, Wwt, Ds, Gd, Hd, Md, Hhd, Md^Xm
Md, Md^Xm, Md, Hhd, Hhd, Dd^Ftd, Rd, Dd, Hd, Rd, Wwt, Hd, Cdr, Gd^Fts, Gd, Ce, 2 Kdr, Wwf^Cov, Gd, Wwt, Cdr^Dr, Ds, Hd, Hd, Rd, Dd^Ftd, Dd^Ftd, Wwt, Ds, Wwt, Ds, Ds, Dd^Ftd, Gs, Md, Md^Xm, Md^Xm
Md, Md, Md, Md, Dd^Ftd, Rd, Hd, Wwt, Wot, Wwt, Hhd, Hd, Ce, Gs^Vc, Gs, Wwf, Cdr, Cdr, Rd, Gs^Vc, Cdr, Kdr, Hd, Dd, Gd, Dd^Ftd, Dd, Ds, Dd^Ftd, Dd^Ftd, Gs^Ftp, Ds, Rd, Gd, Md, Md^Xm, Md^Xm
Md, Md, Md, Md, Dd, Hd, Dd, Wwt, Wwt, Dd^Ftd, Hd, Rd^Dr, Dd, Hd, Dd, Hd, Hd, Hd, Hd, Ce, Rd, Rd, Rd, Hd, Hd, Gd^Fts, Gs^Ft, Rd, Rd, Hd, Gs^Ft, Dd, Gd^Fts, Md, Hhd, Md^Xm, Md
Md, Md^Xm, Md, Gs^Ft, Rd, Ds, Gs, Gs^Ft, Gd^Fts, Rd, Gd, Gs^Ft, Gs^Ft, Re^Gvs, Re^Gvs, Dd, Rd, Dd, Dd, Rd, Gs^Ft, Gs^Ft, Gs, Hd, Gs^Ftp, Gd^Fts, Dd, Dd, Ds, Gd^Fts, Hd, Gd^Fts, Gd^Fts, Gs^Ft, Gd^Fts, Md, Md
Md^Xm, Md^Xm, Md, Gs^Ft, Hd, Rd, Hd, Gd^Fts, Rd, Re^Gvs, Hd, Gs^Ft, Gd^Fts, Hd, Re^Gvs, Dd^Vdt, Hd, Gd^Fts, Hd, Rd, Gd^Fts, Gs^Ft, Gs^Ft, Hd, Rd, Gd^Fts, Hd, Gd^Fts, Gd^Fts, Re^Gvs, Re^Vct, Hd, Hd, Gd^Fts, Gd^Fts, Md, Md
Md^Xm, Md^Xm, Md, Gd^Fts, Gd^Fts, Rd, Dd, Rd, Ds, Rd, Hd, Gd^Fts, Hd, Rd, Dd, Hd, Gs^Ft, Gd^Fts, Gd^Fts, Hd, Rd, Gd^Fts, Gs^Ft, Gd, Hd, Gd^Fts, Gd^Fts, Hd, Gs^Ft, Re^Gvs, Re^Gvs, Hd, Gs^Ft, Hhd, Md, Md^Xm, Md
Md^Xm, Md, Gs^Ft, Hd, Dd, Rd, Gs^Ft, Gs^Ft, Hd, Rd, Hd, Hd, Rd, Hd, Dd, Gd^Fts, Gs^Ft, Gs^Ft, Dd, Dd, Gd^Fts, Hd, Hd, Gs^Ft, Dd, Rd, Hd, Gs^Ft, Dd, Hd, Gd^Fts, Gd^Fts, Hd, Hd, Hhd, Md, Md^Xm
Hhd, Md, Hhd, Rd, Ds, Dd, Hd, Rd, Hd, Dd, Hd, Hhd^Vhhr, Md, Hd, Dd, Rd, Hd, Hd, Dd, Gd^Fts, Rd, Gd^Fts, Ds, Rd, Rd, Hd, Hd, Dd, Md, Rd, Rd, Dd, Ds, Md, Md, Md, Md^Xm
Md, Md, Hd, Dd, Md, Dd, Hd, Gd^Fts, Rd, Rd, Hd, Hd, Md, Hhd, Hd, Rd, Md, Md, Ds, Dd, Rd, Dd, Hd, Hd, Hd, Hd, Hd, Md, Md, Rd, Rd, Gd^Fts, Gd^Fts, Gd^Fts, Hhd, Md, Md^Xm
Md, Md, Md, Md, Md, Md, Hd, Dd^Ftd, Hd, Hd, Dd, Hhd, Md, Md, Md, Hhd, Md, Md, Dd, Rd, Dd, Dd, Hd, Hhd, Hhd, Hhd, Md, Md, Md, Dd, Hd, Rd, Hd, Gd^Fts, Hhd, Md^Xm, Md^Xm
Md, Md, Md, Md, Ql, Hhd, Qxe, Hd, Rd, Hd, Dd, Hhd, Md, Md, Md, Md, Hhd, Rd, Dd, Rd, Rd, Dd, Rd, Hhd, Md, Md, Md, Md, Dd, Ds, Rd, Gd^Fts, Md, Hhd, Md^Xm, Md^Xm, Md
Md, Md, Md, Qlf, Ql, Ql, Qxe, Qxe, Rd, Dd, Rd, Hd, Hd, Md^Xm, Md^Xm, Md, Ql, Rd, Rd, Dd, Rd, Rd, Hd, Hhd, Md^Xm, Md^Xm, Md^Xm, Hhd, Dd, Rd, Dd, Dd, Md, Md^Xm, Md^Xm, Md, Md^Xm
Md, Md, Md^Xm, Md, Md, Ql, Dd, Rd, Rd, Rd, Qxe, Rd, Ql, Md^Xm, Xu, Xu, Qlf, Ql, Ql, Rd, Rd, Rd, Dd, Hhd, Xu, Md^Xm, Md, Md, Rd, Rd, Dd, Md, Md, Md, Md, Md^Xm, Md^Xm
Md, Md^Xm, Md^Xm, Md^Xm, Xu, Qxe, Dd, Rd, Dd, Rd, Qxe, Ql, Qlf, Xu, Xu, Xu, Xu, Qlf, Ql, Qxe, Ur, Qxe, Ql, Xu, Xu, Xu, Xu, Xu, Dd, Rd, Xu, Md, Xu, Md, Md, Md^Xm, Md
Md, Md^Xm, Xu, Xu, Xu, Dd, Ql, Rd, Rd, Xu, Xu, Qlf, Qlf, Qlf, Xu, Xu, Xu, Qxe, Qxe, Ur, Ur, Qxe, Ql, Qlf, Xu, Xu, Qlf, Ql, Ur, Dd, Xu, Xu, Xu, Xu, Xu, Md, Md
Xu, Xu, Xu, Xu, Ql, Ql, Ur, Ur, Ql, Xu, Xu, Xu, Ql, Ql, Ur, Uue, Uu^Vu, Xu, Ql, Qxe, Ur, Ur, Uh^Ii, Qlf, Qxe, Xu, Ql, Ql, Ur, Ql, Ql, Qlf, Xu, Xu, Xu, Xu, Xu
Xu, Xu, Xu, Xu, Ur, Ur, Ql, Ql, Xu, Xu, Xu, Xu, Uu^Ii, Uh, Ce, Ce, Ce, Uh, Ur, Ur, Ur, Uu, Ur, Xu, Qxe, Qxe, Uu, Ql, Ur, Ql, Xu, Qlf, Xu, Xu, Xu, Xu, Xu
Xu, Xu, Uh^Ii, Uu^Vu, Ur, Ql, Uu, Uue, Uu, Ql, Uu^Vu, Uue, Ur, Uue, Ce, 1 Ke, Ce, Ur, Uu^Ii, Uh^Ii, Ur, Uu, Ur, Uu^Vu, Qxe, Uh, Uh, Uh, Ur, Ur, Xu, Xu, Ql, Ql, Xu, Xu, Xu
Uu, Ql, Ql, Uue, Uu, Ur, Ur, Uh^Ii, Ur, Ql, Uu, Ur, Uh^Ii, Uu, Uue, Ce, Uue, Uh, Uue, Uu, Uh, Ur, Uu, Ur, Ur, Uh^Ii, Ur, Uu, Uh^Ii, Ur, Uue, Ql, Qlf, Qlf, Ql, Xu, Xu
Qlf, Qlf, Ql, Ur, Uh, Uh, Uu^Vu, Ur, Uue, Ur, Ur, Ur, Uu, Uh, Uu, Uu, Ur, Uu^Vu, Ur, Uue, Ur, Ur, Uue, Uue, Qxe, Ur, Ur, Uu^Vu, Uue, Ur, Uu, Ql, Qlf, Ql, Ql, Qlf, Xu
Ql, Qlf, Ql, Ql, Uue, Uue, Uu, Uh, Uu, Uu^Ii, Uue, Ur, Uue, Uue, Uu, Uue, Uu, Uu, Uu, Uue, Ur, Ur^Ii, Uue, Ur, Uu, Uh, Uu, Uue, Uue, Uu, Uu, Ql, Ql, Qlf, Ql, Xu, Xu
