Rr, Rr, Xu, Xu, Xu, Xu, Qxe, Rr, Xu, Xu, Rr, Rr, Rr, Xu, Xu, Xu, Xu, Xu, Xu, Xu, Xu, Xu, Xu, Xu, Xu, Xu, Xu
Rr, Rr, Rp, Xu, Xu, Qxe, Qxe, Rr, Qxe, Xu, Rr, Rr, Qxe, Rr, Qxe, Xu, Xu, Rr, Rr^Dr, Rr, Rr, Xu, Rr, Rr, Rr, Xu, Xu
Qxe, Rr, Rp, Rp, Rp, Rr, Rr, Rr, Rr, Rr, Qxe, Qxe, Rr, Rp, Rr, Rr, Rr, Xu, Rr, Rp, Rr, Rr, Qxe, Rr^Dr, Rr, Rr^Dr, Xu
Xu, Xu, Rp, Rr^Dr, Rp, Rr, Rp, Rr^Dr, Rr, Rp, Rr, Rr, Rr, Rp, Rp, Rp, Rp, Xu, Rp, Rp, Qxe, Xu, Qxe, Rr, Rr, Xu, Xu
Xu, Xu, Rp, Rp, Rr, Rr, Xu, Xu, Xu, Rr, Rr, Qxe, Qxe, Rp^Dr, Rp, Qxe, Rr, Rr, Rr^Dr, Rr, Qxe, Xu, Rr, Rp, Rr, Qxe, Rr
Xu, Xu, Rr, Qxe, Qxe, Rr, Rr, Rr, Xu, Rr, Rr, Rp, Qxe, Rp, Rr, Rp, Rr, Rp, Rr, Rp, Rp, Rr, Rp, Xu, Xu, Rr, Rr
Rr, Rr, Qxe, Rr, Rr, Rr^Dr, Rr, Rr, Rr, Rr, Rr, Qxe, Rp, Rp, Rr, Qxe, Rr, Rr, Rp, Rp, Qxe, Rr, Rr, Rr^Dr, Rp, Xu, Xu
Rr, Rr, Qxe, Rr, Rr, Rp, Qxe, Rr, Rp, Rr, Rp, Rp, Rp, Rp, Rp, Qxe, Rr, Rr, Xu, Rr, Rr, Rr, Rr, Rr, Qxe, Rr, Xu
Rr, Rr, Xu, Xu, Rr, Rr, Qxe, Rr, Rr, Rr, Qxe, Rp, Rp, Rp, Rr^Dr, Rp, Rr, Xu, Xu, Xu, Qxe, Rp^Dr, Rr, Rr, Rr, Xu, Xu
Xu, Xu, Qxe, Rp, Rp^Dr, Rr, Rp, Qxe, Rr, Qxe, Rp^Dr, Rp, Rr, Rr, Rp, Rr, Rr, Xu, Xu, Xu, Qxe, Rp, Rr, Rr^Dr, Rr, Xu, Xu
Qxe, Qxe, Qxe, Rp, Rp^Dr, Xu, Xu, Rp, Rp, Qxe, Rp, Rr, Rp, Rr, Rp, Rr, Rp, Rr, Rr, Rp, Rr, Qxe, Qxe, Rp, Rr, Rr, Xu
Xu, Xu, Rr^Dr, Rr, Rp, Rr, Rp, Xu, Xu, Rr, Rr, Rr, Rp, Rp, Rp, Rp, Qxe, Rp, Rr, Qxe, Qxe, Qxe, Xu, Xu, Xu, Qxe, Xu
Xu, Xu, Rr, Rr, Qxe, Rp, Qxe, Xu, Rr, Rr, Rp^Dr, Rp, Rr, Rr^Dr, Qxe, Rp, Xu, Rr, Rr, Xu, Qxe, Xu, Xu, Rr, Xu, Rr, Xu
Xu, Xu, Rp^Dr, Rp, Rr, Qxe, Qxe, Xu, Rr, Rr, Rr, Rr, Rp, Rr, Rr, Rr, Rp, Xu, Rr, Rp, Rp, Rr, Rr, Rp, Qxe, Xu, Xu
Rp, Rp, Rr, Rr, Rr, Rr^Dr, Rr, Rp, Rr, Rp, Rp, Rp^Dr, Rp, Rp, Rp, Rr, Rr, Xu, Rp, Rr^Dr, Rp, Rp, Qxe, Rp, Rr, Xu, Xu
Rp, Qxe, Rp, Rr, Qxe, Rp, Xu, Xu, Xu, Qxe, Rr, Qxe, Qxe, Rr, Rr, Rr, Rr, Rr, Qxe, Rp, Rp, Xu, Rr, Rp, Rp, Rr, Rr
Rr, Rp, Qxe, Xu, Xu, Qxe, Xu, Xu, Rr^Dr, Rp, Rr, Rr, Rr, Rp^Dr, Rr, Qxe, Xu, Rr, Qxe, Rr, Rr, Xu, Xu, Rr^Dr, Rp, Rr, Rr
Rr, Rr, Xu, Xu, Xu, Xu, Xu, Xu, Rp, Rp, Rr, Qxe, Qxe, Rp, Rp, Qxe, Xu, Rr, Rp, Rp, Rr, Xu, Xu, Xu, Rr, Rp, Rr
