border_size=1
usage=map

Ww, Gg, Gg, Gg, Gg, Gg, Gg, Gg, Gg, Gg, Gg, Gg, Gg, Gg, Gg, Gg
Gg, Ww, Ww, Ww, Ww, Gg^Efm, Gll^Fp, Gll^Fp, Gg, Gg^Efm, Gs^Fms, Gg, Gs^Fms, Gg, Gs^Fds, Gg
Gg, Gg, Gs^Efm, Gg, Ww, Gg, Gg, Gll^Fp, Gg^Efm, Gg, Gs^Fms, Gg, Gg, Gs^Fms, Gg^Efm, Gs^Fds
Gg, Gg^Efm, Gs^Fms, Gg, Ww, Gg, Gg, Gg^Efm, Gg^Efm, Gg, Gll^Fp, Gs^Fms, Gll^Fp, Gg, Gg, Gg
Gg, Gg^Efm, Gs^Fms, Gg, Gg, Ww, Ww, Gg, Gs^Fds, Gg, Gg, Gg, Gg, Gll^Fp, Gg, Gg
Gg^Efm, Gg^Efm, Gs^Fms, Gg, Gg, Ww, Ww, Ww, Gs^Fds, Gg, Gll^Fp, Gg, Gg, Gg, Gs^Fms, Gg
Gg, Gg, Gs^Fms, Gg, Gg^Efm, Gs^Fds, Gs^Fds, Ww, Gs^Fds, Gs^Fds, Gg, Gll^Fp, Gg, Gg, Gs^Fms, Gs^Fds
Gg, Gg, Gg, Gg, Gg, Gg^Efm, Gg, Ww, Ww, Gg, Gg, Gll^Fp, Gg, Gg^Efm, Gg, Gg
Gg, Gll^Fp, Gs^Fms, Gs^Fms, Gg, Gg^Efm, 1 Gg, Gg, Gg, Ww, Ww, Gg, Gg^Efm, Gg^Efm, Gg, Gg
Gg, Gg, Gs^Fms, Gs^Fms, Gg, Gg^Efm, Gll^Efm, Gg, Gg, Gg^Fet, Ww, Gg, Gg^Efm, Gg, Gg, Gg
Gg, Gg, Gg, Gs^Fms, Gs^Fms, Gg, Gll^Fp, Gg, Gg, Ww, Ww, Gg, Gg, Gg^Efm, Gg, Gg
Gg, Gg, Gg^Efm, Gg, Gg, Gs^Fms, Gg, Gg, Gg^Efm, Ww, Ww, Ww, Ww, Gg, Ww, Gg
Gg, Gs^Fms, Gs^Fms, Gg, Gg, Gs^Fms, Gg, Gg, Gg, Gg, Gg, Gg, Gg, Ww, Ww, Ww
Gg, Gg, Gs^Fms, Gs^Fms, Gs^Fms, Gs^Fms, Gs^Fms, Gll^Fp, Gll^Fp, Gg, Gs^Fds, Gg, Gg^Efm, Gg, Gs^Fds, Gg
Gg, Gg, Gs^Fds, Gs^Fms, Gs^Fds, Gs^Fms, Gg, Gs^Fms, Gg, Gll^Fp, Gg, Gg^Efm, Gg^Efm, Gg^Efm, Gs^Fds, Gs^Fds
Gg, Gs^Fds, Gg, Gg, Gg, Gg, Gg, Gg, Gs^Fds, Gg, Gg, Gg, Gg^Efm, Gg, Gg, Gg
