Xos, Xos, Xos, Xos, Xos, Xos, Xos, Xos, Xos, Xos, Xos, Xos, Xos, Xos, Xos, Xos, Xos, Xos, Xos, Xos, Xos, Xos, Xos, Xos, Xos, Xos, Xos, Xos, Xos, Xos, Xos, Xos, Xos, Xos, Urb, Rr, Urb, Xos, Xos, Xos, Xos, Xos, Xos, Xos, Xos, Xos, Xos, Xos, Xos, Xos, Xos, Xos, Xos, Xos, Xos, Xos, Xos, Xos, Xos, Xos, Xos, Xos, Xos, Xos, Xos, Xos, Xos, Xos, Xos, Xos, Xos, Xos
Xos, Xos, Xos, Xos, Xos, Xos, Xos, Xos, Xos, Xos, Xos, Xos, Xos, Xos, Xos, Xos, Xos, Xos, Xos, Xos, Xos, Xos, Xos, Xos, Xos, Xos, Xos, Xos, Xos, Xos, Xos, Xos, Xos, Xos, Urb, Rr, Urb, Xos, Xos, Xos, Xos, Xos, Xos, Xos, Xos, Xos, Xos, Xos, Xos, Xos, Xos, Xos, Xos, Xos, Xos, Xos, Xos, Xos, Xos, Xos, Xos, Xos, Xos, Xos, Xos, Xos, Xos, Xos, Xos, Xos, Xos, Xos
Xos, Xos, Xos, Xos, Xos, Xos, Xos, Xos, Xos, Xos, Xos, Xos, Xos, Xos, Xos, Xos, Xos, Xos, Xos, Xos, Xos, Xos, Xos, Xos, Xos, Xos, Xos, Xos, Xos, Xos, Xos, Xos, Xos, Xos, Urb, Rr, Urb, Xos, Xos, Xos, Xos, Xos, Xos, Xos, Xos, Xos, Xos, Xos, Xos, Xos, Xos, Xos, Xos, Xos, Xos, Xos, Xos, Xos, Xos, Xos, Xos, Xos, Xos, Xos, Xos, Xos, Xos, Xos, Xos, Xos, Xos, Xos
Xos, Xos, Xos, Xos, Xos, Xos, Xos, Xos, Xos, Xos, Xos, Xos, Xos, Xos, Xos, Xos, Xos, Xos, Xos, Xos, Xos, Xos, Xos, Xos, Xos, Xos, Xos, Xos, Xos, Xos, Xos, Xos, Xos, Xos, Urb, Rr, Urb, Xos, Xos, Xos, Xos, Xos, Xos, Xos, Xos, Xos, Xos, Xos, Xos, Xos, Xos, Xos, Xos, Xos, Xos, Xos, Xos, Xos, Xos, Xos, Xos, Xos, Xos, Xos, Xos, Xos, Xos, Xos, Xos, Xos, Xos, Xos
Xos, Xos, Xos, Xos, Xos, Xos, Xos, Xos, Xos, Xos, Xos, Xos, Xos, Xos, Xos, Xos, Xos, Xos, Xos, Xos, Xos, Xos, Xos, Xos, Xos, Xos, Xos, Xos, Xos, Xos, Xos, Xos, Xos, Xos, Urb, Rr, Urb, Xos, Xos, Xos, Xos, Xos, Xos, Xos, Xos, Xos, Xos, Xos, Xos, Xos, Xos, Xos, Xos, Xos, Xos, Xos, Xos, Xos, Xos, Xos, Xos, Xos, Xos, Xos, Xos, Xos, Xos, Xos, Xos, Xos, Xos, Xos
Xos, Xos, Xos, Xos, Xos, Xos, Xos, Xos, Xos, Xos, Xos, Xos, Xos, Xos, Xos, Xos, Xos, Xos, Xos, Xos, Xos, Xos, Xos, Xos, Xos, Xos, Xos, Xos, Xos, Xos, Xos, Xos, Xos, Xos, Urb, Rr, Urb, Xos, Xos, Xos, Xos, Xos, Xos, Xos, Xos, Xos, Xos, Xos, Xos, Xos, Xos, Xos, Xos, Xos, Xos, Xos, Xos, Xos, Xos, Xos, Xos, Xos, Xos, Xos, Xos, Xos, Xos, Xos, Xos, Xos, Xos, Xos
Xos, Xos, Xos, Xos, Xos, Xos, Xos, Xos, Xos, Xos, Xos, Xos, Xos, Xos, Xos, Xos, Xos, Xos, Xos, Xos, Xos, Xos, Xos, Xos, Xos, Xos, Xos, Xos, Xos, Xos, Xos, Xos, Xos, Xos, Urb, Rr, Urb, Xos, Xos, Xos, Xos, Xos, Xos, Xos, Xos, Xos, Xos, Xos, Xos, Xos, Xos, Xos, Xos, Xos, Xos, Xos, Xos, Xos, Xos, Xos, Xos, Xos, Xos, Xos, Xos, Xos, Xos, Xos, Xos, Xos, Xos, Xos
Xos, Xos, Xos, Xos, Xos, Xos, Xos, Xos, Xos, Xos, Xos, Xos, Xos, Xos, Xos, Xos, Xos, Xos, Xos, Xos, Xos, Xos, Xos, Xos, Xos, Xos, Xos, Xos, Xos, Xos, Xos, Xos, Xos, Xos, Urb, Rr, Urb, Xos, Xos, Xos, Xos, Xos, Xos, Xos, Xos, Xos, Xos, Xos, Xos, Xos, Xos, Xos, Xos, Xos, Xos, Xos, Xos, Xos, Xos, Xos, Xos, Xos, Xos, Xos, Xos, Xos, Xos, Xos, Xos, Xos, Xos, Xos
Xos, Xos, Xos, Xos, Xos, Xos, Xos, Xos, Xos, Xos, Xos, Xos, Xos, Xos, Xos, Xos, Xos, Xos, Xos, Xos, Xos, Xos, Xos, Xos, Xos, Xos, Xos, Xos, Xos, Xos, Xos, Xos, Urb, Urb, Rr, Rr, Rr, Urb, Urb, Xos, Xos, Xos, Xos, Xos, Xos, Xos, Xos, Xos, Xos, Xos, Xos, Xos, Xos, Xos, Xos, Xos, Xos, Xos, Xos, Xos, Xos, Xos, Xos, Xos, Xos, Xos, Xos, Xos, Xos, Xos, Xos, Xos
Xos, Xos, Xos, Xos, Xos, Xos, Xos, Xos, Xos, Xos, Xos, Xos, Xos, Xos, Xos, Xos, Xos, Xos, Xos, Xos, Xos, Xos, Xos, Xos, Xos, Xos, Xos, Xos, Xos, Xos, Urb, Urb, Rr, Rr, Rr, Rr^Dr, Qxu, Rr, Rr, Urb, Urb, Xos, Xos, Xos, Xos, Xos, Xos, Xos, Xos, Xos, Xos, Xos, Xos, Xos, Xos, Xos, Xos, Xos, Xos, Xos, Xos, Xos, Xos, Xos, Xos, Xos, Xos, Xos, Xos, Xos, Xos, Xos
Xos, Xos, Xos, Xos, Xos, Xos, Xos, Xos, Xos, Xos, Xos, Xos, Xos, Xos, Xos, Xos, Xos, Xos, Xos, Xos, Xos, Xos, Xos, Xos, Xos, Xos, Xos, Xos, Urb, Urb, Rr, Rr, Rr^Dr, Rr, Rr, Qxu, Rr, Rr, Rr^Dr, Rr, Rr, Urb, Urb, Xos, Xos, Xos, Xos, Xos, Xos, Xos, Xos, Xos, Xos, Xos, Xos, Xos, Xos, Xos, Xos, Xos, Xos, Xos, Xos, Xos, Xos, Xos, Xos, Xos, Xos, Xos, Xos, Xos
Xos, Xos, Xos, Xos, Xos, Xos, Xos, Xos, Xos, Xos, Xos, Xos, Xos, Xos, Xos, Xos, Xos, Xos, Xos, Xos, Xos, Xos, Xos, Xos, Xos, Xos, Xos, Xos, Urb, Rr, Rr^Dr, Qxu, Rr, Rr, Chr, Qxu, Chr, Rr, Rr, Rr, Rr, Rr, Urb, Xos, Xos, Xos, Xos, Xos, Xos, Xos, Xos, Xos, Xos, Xos, Xos, Xos, Xos, Xos, Xos, Xos, Xos, Xos, Xos, Xos, Xos, Xos, Xos, Xos, Xos, Xos, Xos, Xos
Xos, Xos, Xos, Xos, Xos, Xos, Xos, Xos, Xos, Xos, Xos, Xos, Xos, Xos, Xos, Xos, Xos, Xos, Xos, Xos, Xos, Xos, Xos, Xos, Xos, Xos, Xos, Xos, Urb, Rr, Rr, Rr, Rr, Chr, Rr^Vhcr, Chr, Rr^Vhcr, Chr, Rr, Rr, Rr^Dr, Rr^Dr, Urb, Xos, Xos, Xos, Xos, Xos, Xos, Xos, Xos, Xos, Xos, Xos, Xos, Xos, Xos, Xos, Xos, Xos, Xos, Xos, Xos, Xos, Xos, Xos, Xos, Xos, Xos, Xos, Xos, Xos
Xos, Xos, Xos, Xos, Xos, Xos, Xos, Xos, Xos, Xos, Xos, Xos, Xos, Xos, Xos, Xos, Xos, Xos, Xos, Xos, Xos, Xos, Xos, Xos, Xos, Xos, Xos, Xos, Urb, Qxu, Rr^Dr, Rr, Chr, Chr, Chr, Chr, Chr, Chr, Chr, Rr, Rr^Dr, Rr, Urb, Xos, Xos, Xos, Xos, Xos, Xos, Xos, Xos, Xos, Xos, Xos, Xos, Xos, Xos, Xos, Xos, Xos, Xos, Xos, Xos, Xos, Xos, Xos, Xos, Xos, Xos, Xos, Xos, Xos
Xos, Xos, Xos, Xos, Xos, Xos, Xos, Xos, Xos, Xos, Xos, Xos, Xos, Xos, Xos, Xos, Xos, Xos, Xos, Xos, Xos, Xos, Xos, Xos, Xos, Xos, Xos, Xos, Urb, Qxu, Rr, Qxu, Chr, Rr^Vhcr, Chr, Khr, Chr, Rr^Vhcr, Chr, Rr, Qxu, Qxu, Urb, Xos, Xos, Xos, Xos, Xos, Xos, Xos, Xos, Xos, Xos, Xos, Xos, Xos, Xos, Xos, Xos, Xos, Xos, Xos, Xos, Xos, Xos, Xos, Xos, Xos, Xos, Xos, Xos, Xos
Xos, Xos, Xos, Xos, Xos, Xos, Xos, Xos, Xos, Xos, Xos, Xos, Xos, Xos, Xos, Xos, Xos, Xos, Xos, Xos, Xos, Xos, Xos, Xos, Xos, Xos, Xos, Xos, Urb, Rr, Rr^Dr, Rr, Rr, Chr, Rr^Vhcr, Chr, Rr^Vhcr, Chr, Rr, Rr, Rr^Dr, Rr, Urb, Xos, Xos, Xos, Xos, Xos, Xos, Xos, Xos, Xos, Xos, Xos, Xos, Xos, Xos, Xos, Xos, Xos, Xos, Xos, Xos, Xos, Xos, Xos, Xos, Xos, Xos, Xos, Xos, Xos
Xos, Xos, Xos, Xos, Xos, Xos, Xos, Xos, Xos, Xos, Xos, Xos, Xos, Xos, Xos, Xos, Xos, Xos, Xos, Xos, Xos, Xos, Xos, Xos, Xos, Xos, Xos, Xos, Urb, Rr^Dr, Qxu, Rr, Rr, Chr, Chr, Chr, Chr, Chr, Rr^Dr, Rr, Rr, Rr, Urb, Xos, Xos, Xos, Xos, Xos, Xos, Xos, Xos, Xos, Xos, Xos, Xos, Xos, Xos, Xos, Xos, Xos, Xos, Xos, Xos, Xos, Xos, Xos, Xos, Xos, Xos, Xos, Xos, Xos
Xos, Xos, Xos, Xos, Xos, Xos, Xos, Xos, Xos, Xos, Xos, Xos, Xos, Xos, Xos, Xos, Xos, Xos, Xos, Xos, Xos, Xos, Xos, Xos, Xos, Xos, Xos, Xos, Urb, Rr, Rr, Rr^Dr, Rr, Rr, Rr^Dr, Qxu, Rr, Rr, Rr, Qxu, Rr, Rr, Urb, Xos, Xos, Xos, Xos, Xos, Xos, Xos, Xos, Xos, Xos, Xos, Xos, Xos, Xos, Xos, Xos, Xos, Xos, Xos, Xos, Xos, Xos, Xos, Xos, Xos, Xos, Xos, Xos, Xos
Xos, Xos, Xos, Xos, Xos, Xos, Xos, Xos, Xos, Xos, Xos, Xos, Xos, Xos, Xos, Xos, Xos, Xos, Xos, Xos, Xos, Xos, Xos, Xos, Xos, Xos, Xos, Xos, Xos, Urb, Urb, Rr, Rr, Rr^Dr, Rr, Rr^Dr, Rr, Rr^Dr, Rr^Dr, Qxu, Urb, Urb, Xos, Xos, Xos, Xos, Xos, Xos, Xos, Xos, Xos, Xos, Xos, Xos, Xos, Xos, Xos, Xos, Xos, Xos, Xos, Xos, Xos, Xos, Xos, Xos, Xos, Xos, Xos, Xos, Xos, Xos
Xos, Xos, Xos, Xos, Xos, Xos, Xos, Xos, Xos, Xos, Xos, Xos, Xos, Xos, Xos, Xos, Xos, Xos, Xos, Xos, Xos, Xos, Xos, Xos, Xos, Xos, Xos, Xos, Xos, Xos, Xos, Urb, Urb, Rr, Rr, Rr^Dr, Rr, Rr, Urb, Urb, Xos, Xos, Xos, Xos, Xos, Xos, Xos, Xos, Xos, Xos, Xos, Xos, Xos, Xos, Xos, Xos, Xos, Xos, Xos, Xos, Xos, Xos, Xos, Xos, Xos, Xos, Xos, Xos, Xos, Xos, Xos, Xos
Xos, Xos, Xos, Xos, Xos, Xos, Xos, Xos, Xos, Xos, Xos, Xos, Xos, Xos, Xos, Xos, Xos, Xos, Xos, Xos, Xos, Xos, Xos, Xos, Xos, Xos, Xos, Xos, Xos, Xos, Xos, Xos, Xos, Urb, Urb, Rr, Urb, Urb, Xos, Xos, Xos, Xos, Xos, Xos, Xos, Xos, Xos, Xos, Xos, Xos, Xos, Xos, Xos, Xos, Xos, Xos, Xos, Xos, Xos, Xos, Xos, Xos, Xos, Xos, Xos, Xos, Xos, Xos, Xos, Xos, Xos, Xos
Xos, Xos, Xos, Xos, Xos, Xos, Xos, Xos, Xos, Xos, Xos, Xos, Xos, Xos, Xos, Xos, Xos, Xos, Xos, Xos, Xos, Xos, Xos, Xos, Xos, Xos, Xos, Xos, Xos, Xos, Xos, Xos, Xos, Xos, Urb, Rr, Urb, Xos, Xos, Xos, Xos, Xos, Xos, Xos, Xos, Xos, Xos, Xos, Xos, Xos, Xos, Xos, Xos, Xos, Xos, Xos, Xos, Xos, Xos, Xos, Xos, Xos, Xos, Xos, Xos, Xos, Xos, Xos, Xos, Xos, Xos, Xos
Xos, Xos, Xos, Xos, Xos, Xos, Xos, Xos, Xos, Xos, Xos, Xos, Xos, Xos, Xos, Xos, Xos, Xos, Xos, Xos, Xos, Xos, Xos, Xos, Xos, Xos, Xos, Xos, Xos, Xos, Xos, Xos, Xos, Xos, Urb, Rr, Urb, Xos, Xos, Xos, Xos, Xos, Xos, Xos, Xos, Xos, Xos, Xos, Xos, Xos, Xos, Xos, Xos, Xos, Xos, Xos, Xos, Xos, Xos, Xos, Xos, Xos, Xos, Xos, Xos, Xos, Xos, Xos, Xos, Xos, Xos, Xos
Xos, Xos, Xos, Xos, Xos, Xos, Xos, Xos, Xos, Xos, Xos, Xos, Xos, Xos, Xos, Xos, Xos, Xos, Xos, Xos, Xos, Xos, Xos, Xos, Xos, Xos, Xos, Xos, Xos, Xos, Xos, Xos, Xos, Xos, Chr, Rr, Chr, Xos, Xos, Xos, Xos, Xos, Xos, Xos, Xos, Xos, Xos, Xos, Xos, Xos, Xos, Xos, Xos, Xos, Xos, Xos, Xos, Xos, Xos, Xos, Xos, Xos, Xos, Xos, Xos, Xos, Xos, Xos, Xos, Xos, Xos, Xos
Xos, Xos, Xos, Xos, Xos, Xos, Xos, Xos, Xos, Xos, Xos, Xos, Xos, Xos, Xos, Xos, Xos, Xos, Xos, Xos, Xos, Xos, Xos, Xos, Xos, Xos, Xos, Xos, Xos, Xos, Xos, Xos, Urb, Urb, Rr, Rr, Rr, Urb, Urb, Xos, Xos, Xos, Xos, Xos, Xos, Xos, Xos, Xos, Xos, Xos, Xos, Xos, Xos, Xos, Xos, Xos, Xos, Xos, Xos, Xos, Xos, Xos, Xos, Xos, Xos, Xos, Xos, Xos, Xos, Xos, Xos, Xos
Xos, Xos, Xos, Xos, Xos, Xos, Xos, Xos, Xos, Xos, Xos, Xos, Xos, Xos, Xos, Xos, Xos, Xos, Xos, Xos, Xos, Xos, Xos, Xos, Xos, Xos, Xos, Xos, Xos, Xos, Urb, Urb, Rr, Rr, Rr, Rr, Rr, Rr, Rr, Urb, Urb, Xos, Xos, Xos, Xos, Xos, Xos, Xos, Xos, Xos, Xos, Xos, Xos, Xos, Xos, Xos, Xos, Xos, Xos, Xos, Xos, Xos, Xos, Xos, Xos, Xos, Xos, Xos, Xos, Xos, Xos, Xos
Xos, Xos, Xos, Xos, Xos, Xos, Xos, Xos, Xos, Xos, Xos, Xos, Xos, Xos, Xos, Xos, Xos, Xos, Xos, Xos, Xos, Xos, Xos, Xos, Xos, Xos, Xos, Xos, Xos, Urb, Rr, Rr, Urb, Rr, Urb, Rr, Urb, Rr, Urb, Rr, Rr, Urb, Xos, Xos, Xos, Xos, Xos, Xos, Xos, Xos, Xos, Xos, Xos, Xos, Xos, Xos, Xos, Xos, Xos, Xos, Xos, Xos, Xos, Xos, Xos, Xos, Xos, Xos, Xos, Xos, Xos, Xos
Xos, Xos, Xos, Xos, Xos, Xos, Xos, Xos, Xos, Xos, Xos, Xos, Xos, Xos, Xos, Xos, Urb, Urb, Urb, Xos, Xos, Xos, Urb, Xos, Xos, Xos, Rr, Xos, Rr, Rr, Urb, Urb, Xos, Urb, Xos, Urb, Xos, Urb, Xos, Urb, Rr, Urb, Urb, Xos, Urb, Xos, Xos, Xos, Xos, Xos, Xos, Xos, Xos, Xos, Xos, Xos, Xos, Xos, Xos, Xos, Xos, Xos, Xos, Xos, Xos, Xos, Xos, Xos, Xos, Xos, Xos, Xos
Xos, Xos, Xos, Xos, Xos, Xos, Xos, Xos, Xos, Xos, Xos, Xos, Xos, Xos, Xos, Xos, Urb, Urb, Rr, Xos, Rr, Rr, Rr, Rr, Rr, Rr, Urb, Rr, Rr, Urb, Xos, Xos, Xos, Xos, Xos, Xos, Xos, Xos, Urb, Urb, Rr, Rr, Rr, Urb, Rr, Urb, Urb, Xos, Xos, Xos, Xos, Xos, Xos, Xos, Xos, Xos, Xos, Xos, Xos, Xos, Xos, Xos, Xos, Xos, Xos, Xos, Xos, Xos, Xos, Xos, Xos, Xos
Xos, Xos, Xos, Xos, Xos, Xos, Xos, Xos, Xos, Xos, Xos, Xos, Xos, Xos, Urb, Urb, Rr, Rr, Urb, Rr, Urb, Urb, Urb, Urb, Urb, Urb, Xos, Urb, Rr, Urb, Xos, Xos, Xos, Xos, Urb, Urb, Urb, Xos, Urb, Rr, Urb, Urb, Xos, Rr, Urb, Rr, Rr, Urb, Urb, Xos, Xos, Xos, Xos, Xos, Xos, Xos, Xos, Xos, Xos, Xos, Xos, Xos, Xos, Xos, Xos, Xos, Xos, Xos, Xos, Xos, Xos, Xos
Xos, Xos, Xos, Xos, Xos, Xos, Xos, Xos, Xos, Xos, Xos, Xos, Urb, Urb, Rr, Rr, Urb, Urb, Xos, Urb, Xos, Xos, Xos, Xos, Xos, Xos, Urb, Urb, Rr, Urb, Xos, Xos, Xos, Urb, Rr, Rr, Rr, Urb, Rr, Rr, Urb, Xos, Xos, Xos, Xos, Xos, Xos, Rr, Rr, Urb, Urb, Urb, Urb, Urb, Urb, Urb, Urb, Urb, Xos, Xos, Xos, Xos, Xos, Xos, Xos, Xos, Xos, Xos, Xos, Xos, Xos, Xos
Xos, Xos, Xos, Xos, Xos, Xos, Xos, Xos, Xos, Xos, Xos, Xos, Urb, Rr, Urb, Urb, Xos, Xos, Ur, Xos, Ur, Qxu, Xos, Xos, Urb, Urb, Rr, Rr, Urb, Urb, Xos, Xos, Xos, Urb, Rr, Urb, Urb, Rr, Urb, Urb, Xos, Xos, Iwr, Iwr, Iwr, Iwr, Iwr, Xos, Xos, Rr, Rr, Rr, Rr, Rr, Rr, Urb, Urb, Urb, Xos, Xos, Xos, Xos, Xos, Xos, Xos, Xos, Xos, Xos, Xos, Xos, Xos, Xos
Xos, Xos, Xos, Xos, Xos, Xos, Xos, Xos, Xos, Xos, Xos, Xos, Urb, Rr, Urb, Xos, Ur, Qxu, Ur, Qxu, Ur, Qxu, Xos, Urb, Rr, Rr, Urb, Urb, Xos, Xos, Xos, Xos, Urb, Chr, Chr, Xos, Xos, Urb, Xos, Xos, Iwr, Iwr, Iwr, Iwr, Iwr, Iwr, Iwr, Iwr, Iwr, Xos, Xos, Xos, Xos, Xos, Xos, Rr, Rr, Urb, Xos, Xos, Xos, Xos, Xos, Xos, Xos, Xos, Urb, Urb, Urb, Xos, Xos, Xos
Xos, Xos, Xos, Xos, Xos, Xos, Xos, Xos, Xos, Xos, Xos, Xos, Urb, Rr, Xos, Xos, Qxu, Ur, Qxu, Ur, Xos, Xos, Urb, Chr, Chr, Urb, Xos, Xos, Xos, Xos, Urb, Urb, Rr, Rr, Xos, Xos, Xos, Xos, Xos, Xos, Xos, Iwr, Iwr, Iwr, Iwr, Xos^Efs, Xos^Efs, Iwr, Iwr, Iwr, Iwr, Iwr, Iwr, Xos, Xos, Xos, Chr, Urb, Xos, Xos, Xos, Xos, Xos, Xos, Urb, Urb^Dr, Urb, Urb^Dr, Urb, Urb, Xos, Xos
Xos, Xos, Xos, Xos, Xos, Xos, Xos, Xos, Xos, Xos, Xos, Xos, Urb, Rr, Rr, Xos, Ur, Ur, Ur, Xos, Urb, Urb, Rr, Rr, Urb, Xos, Xos, Xos, Xos, Urb, Rr, Rr, Xos, Xos, Xos, Xos, Xos, Xos, Urb, Xos, Urb, Xos, Xos, Iwr, Iwr, Iwr, Iwr, Xos^Efs, Iwr, Iwr, Iwr, Iwr, Xos, Xos, Urb, Xos, Rr, Chr, Xos, Xos, Xos, Xos, Urb, Urb, Urb^Dr, Urb, Urb, Urb, Urb, Urb, Xos, Xos
Xos, Xos, Xos, Xos, Xos, Xos, Xos, Xos, Xos, Xos, Xos, Xos, Xos, Urb, Rr, Xos, Xos, Qxu, Qxu, Xos, Urb, Urb, Rr, Urb, Xos, Xos, Xos, Xos, Xos, Urb, Rr, Xos, Xos, Xos, Urb, Urb, Rr, Urb, Rr, Urb, Rr, Urb, Urb, Xos, Xos, Iwr, Iwr, Iwr, Iwr, Iwr, Iwr, Iwr, Xos, Urb, Rr, Rr, Urb, Urb, Xos, Xos, Xos, Xos, Urb^Dr, Qxu, Urb, Urb, Xos, Urb, Urb^Dr, Qxu, Xos, Xos
Xos, Xos, Xos, Xos, Xos, Xos, Iwr, Iwr, Iwr, Xos, Xos, Xos, Xos, Urb, Rr, Xos, Xos, Xos, Xos, Xos, Urb, Urb, Rr, Urb, Xos, Xos, Xos, Xos, Xos, Urb, Urb, Rr, Rr, Urb, Rr, Rr, Xos, Rr, Xos, Rr, Xos, Rr, Rr, Urb, Urb, Xos, Iwr, Iwr, Iwr, Iwr, Xos, Xos, Urb, Urb, Rr, Urb, Xos, Xos, Xos, Xos, Xos, Xos, Urb^Dr, Urb, Urb^Dr, Urb, Urb, Xos, Re, Wwg, Wwg, Xos
Xos, Xos, Xos, Xos, Urb, Iwr, Ce, Iwr, Iwr, Xos, Xos, Xos, Xos, Urb, Rr, Urb, Urb, Xos, Xos, Xos, Xos, Urb, Rr, Urb, Urb, Xos, Xos, Xos, Xos, Urb, Xos, Urb, Urb, Rr, Urb, Xos, Xos, Xos, Iwr, Xos, Xos, Xos, Urb, Rr, Urb, Xos, Iwr, Iwr, Iwr, Iwr, Xos, Urb, Urb, Urb, Rr, Urb, Xos, Xos, Xos, Xos, Xos, Xos, Xos, Urb, Urb^Dr, Urb, Urb, Urb, Xos, Re, Sm, Xos
Xos, Xos, Xos, Urb, Urb, Iwr, Iwr, Ce, Iwr, Xos, Xos, Xos, Urb, Urb, Rr, Rr, Rr, Urb, Xos, Xos, Xos, Urb, Urb, Rr, Rr, Urb, Urb, Xos, Xos, Xos, Xos, Xos, Xos, Urb, Xos, Xos, Cud, Iwr, Iwr, Iwr, Xos, Xos, Urb, Rr, Xos, Xos, Iwr, Xos^Efs, Xos^Efs, Iwr, Xos, Xos, Urb, Urb, Rr, Urb, Urb, Xos, Xos, Xos, Xos, Xos, Xos, Urb, Urb, Urb, Urb^Dr, Urb, Xos, Re, Wwg, Xos
Xos, Xos, Xos, Urb, Ce, Iwr, Iwr, Ce, Xos, Xos, Xos, Urb, Rr, Rr, Chr, Chr, Rr, Urb, Xos, Xos, Xos, Xos, Xos, Urb, Urb, Rr, Urb, Xos, Xos, Xos, Xos, Iwr, Iwr, Xos, Cud, Iwr, Iwr, Cud, Cud, Iwr, Xos, Urb, Rr, Rr, Xos, Xos, Iwr, Iwr, Iwr, Iwr, Xos, Xos, Xos, Urb, Urb, Rr, Rr, Urb, Rr, Urb, Urb, Urb, Urb, Xos, Urb, Urb^Dr, Urb^Dr, Urb, Xos, Re, Sm, Xos
Xos, Xos, Xos, Iwr, Ce, Iwr, Xos, Xos, Urb, Urb, Rr, Rr, Chr, Chr, Khr, Chr, Rr^Vhcr, Urb, Xos, Xos, Xos, Xos, Xos, Xos, Urb, Rr, Rr, Urb, Urb, Xos, Xos, Iwr, Iwr, Cud, Cud, Iwr, Xos, Iwr, Xos, Xos, Rr, Rr, Urb, Xos, Xos, Xos, Iwr, Iwr, Iwr, Iwr, Iwr, Xos, Xos, Xos, Urb, Urb, Urb, Rr, Urb, Rr, Rr, Urb, Urb, Xos, Urb, Urb^Dr, Urb, Urb, Re, Re, Sm, Xos
Xos, Xos, Xos, Iwr, Xos, Xos, Urb, Urb, Rr, Rr, Urb, Rr, Rr, Chr, Chr, Chr, Rr, Urb, Xos, Xos, Qxua, Qxua, Qxua, Xos, Xos, Urb, Urb, Rr, Urb, Xos, Xos, Iwr, Iwr, Iwr, Xos, Xos, Urb, Xos, Rr, Rr, Urb, Urb, Xos, Xos, Iwr, Iwr, Iwr, Iwr, Xos^Efs, Iwr, Iwr, Iwr, Xos, Xos, Xos, Urb, Xos, Urb, Xos, Urb, Urb, Rr, Rr, Xos, Xos, Urb, Urb, Urb, Urb^Dr, Wwg, Xos, Xos
Xos, Xos, Xos, Xos, Xos, Urb, Rr, Rr, Xos, Xos, Xos, Urb, Urb, Rr, Rr, Chr, Rr, Urb, Xos, Qxua, Urb, Urb, Urb, Urb, Urb, Xos, Urb, Rr, Urb, Xos, Xos, Iwr, Iwr, Iwr, Xos, Urb, Urb, Urb, Rr, Urb, Xos, Xos, Iwr, Iwr, Iwr, Iwr, Iwr, Iwr, Xos^Efs, Xos^Efs, Iwr, Iwr, Xos, Xos, Xos, Xos, Xos, Xos, Iwr, Xos, Xos, Urb, Urb, Rr, Rr, Xos, Urb^Dr, Qxu, Urb, Urb, Xos, Xos
Xos, Xos, Xos, Xos, Urb, Urb, Rr, Xos, Xos, Xos, Xos, Xos, Xos, Urb, Urb, Rr, Urb, Urb, Xos, Qxua, Urb, Urb, Urb, Urb, Rr, Xos, Urb, Rr, Urb, Xos, Xos, Xos, Xos, Xos, Xos, Urb, Urb, Urb, Rr, Urb, Xos, Iwr, Iwr, Iwr, Xos^Efs, Iwr, Iwr, Iwr, Iwr, Iwr, Iwr, Iwr, Xos, Xos, Xos, Xos, Iwr, Iwr, Iwr, Iwr, Iwr, Xos, Xos, Urb, Rr, Xos, Urb, Urb^Dr, Qxu, Urb, Xos, Xos
Xos, Xos, Xos, Urb, Rr, Rr, Xos, Xos, Xos, Xos, Xos, Xos, Xos, Xos, Xos, Urb, Xos, Xos, Xos, Urb^Dr, Urb, Rr, Urb, Rr, Urb, Xos, Urb, Rr, Urb, Xos, Xos, Xos, Xos, Xos, Xos, Xos, Xos, Urb, Rr, Urb, Xos, Iwr, Iwr, Iwr, Xos^Efs, Xos^Efs, Iwr, Iwr, Iwr, Iwr, Iwr, Iwr, Xos, Xos, Xos, Xos, Iwr, Iwr, Iwr, Iwr, Iwr, Iwr, Xos, Urb, Rr, Xos, Urb, Urb^Dr, Qxu, Urb, Xos, Xos
Xos, Xos, Xos, Urb, Rr, Xos, Xos, Xos, Xos, Xos, Rr, Xos, Urb, Urb, Urb, Xos, Xos, Xos, Xos, Qxu, Cud, Rr, Cud, Rr, Cud, Xos, Urb, Rr, Urb, Xos, Xos, Xos, Xos, Xos, Xos, Xos, Xos, Urb, Rr, Urb, Xos, Iwr, Iwr, Xos^Efs, Iwr, Iwr, Iwr, Iwr, Iwr, Iwr, Xos, Xos, Urb, Urb, Urb, Xos, Iwr, Iwr, Iwr, Iwr, Iwr, Iwr, Xos, Urb, Rr, Xos, Qxu, Urb, Urb, Urb, Qxu, Xos
Xos, Xos, Xos, Urb, Rr, Xos, Xos, Xos, Rr, Rr, Urb, Rr, Rr, Rr, Rr, Urb, Urb, Xos, Xos, Qxu, Urb, Rr, Rr, Rr, Urb, Xos, Urb, Rr, Urb, Urb, Xos, Xos, Xos, Xos, Xos, Xos, Xos, Chr, Rr, Chr, Xos, Iwr, Iwr, Xos^Efs, Iwr, Iwr, Iwr, Iwr, Xos, Xos, Urb, Urb, Urb, Urb, Rr, Xos, Xos, Iwr, Iwr, Iwr, Iwr, Iwr, Xos, Urb, Rr, Xos, Urb, Qxu, Urb, Urb^Dr, Xos, Xos
Xos, Xos, Xos, Urb, Rr, Xos, Xos, Rr, Urb, Urb, Xos, Urb, Urb, Urb, Urb, Rr, Rr, Urb, Xos, Urb^Dr, Urb^Dr, Urb, Rr, Urb^Dr, Urb^Dr, Xos, Urb, Rr, Rr, Chr, Urb, Xos, Xos, Xos, Xos, Xos, Xos, Urb, Rr, Urb, Xos, Iwr, Iwr, Iwr, Iwr, Iwr, Xos, Xos, Xos, Xos, Chr, Urb, Rr, Rr, Urb, Rr, Rr, Xos, Xos, Iwr, Xos, Xos, Urb, Urb, Rr, Xos, Qxu, Qxu, Urb, Urb, Xos, Xos
Xos, Xos, Xos, Urb, Rr, Xos, Xos, Rr, Urb, Xos, Iwr, Xos, Xos, Xos, Xos, Xos, Urb, Rr, Xos, Urb, Urb^Dr, Urb, Rr, Urb^Dr, Urb^Dr, Xos, Xos, Chr, Urb, Rr, Rr, Urb, Urb, Xos, Xos, Xos, Xos, Urb, Rr, Urb, Urb, Xos, Xos, Iwr, Xos, Xos, Xos, Xos, Urb, Urb, Rr, Rr, Chr, Urb, Xos, Urb, Urb, Rr, Rr, Xos, Urb, Urb, Rr, Rr, Xos, Xos, Urb, Urb^Dr, Urb, Urb, Xos, Xos
Xos, Xos, Xos, Urb, Rr, Xos, Rr, Rr, Urb, Xos, Iwr, Iwr, Iwr, Xos, Xos, Urb, Rr, Rr, Xos, Qxu, Urb, Urb^Dr, Xos, Urb, Xos, Xos, Xos, Xos, Xos, Urb, Urb, Rr, Rr, Urb, Urb, Xos, Xos, Urb, Urb, Rr, Urb, Xos, Xos, Xos, Xos, Xos, Urb, Urb, Rr, Rr, Urb, Urb, Xos, Xos, Xos, Xos, Xos, Urb, Urb, Rr, Rr, Rr, Rr, Urb, Xos, Xos, Xos, Urb, Urb^Dr, Qxu, Xos, Xos
Xos, Xos, Xos, Urb, Urb, Rr, Urb, Urb, Xos, Xos, Iwr^Dr, Iwr, Iwr, Iwr, Xos, Urb, Rr, Xos, Xos, Xos, Xos, Xos, Rr, Xos, Xos, Xos, Xos, Xos, Xos, Xos, Xos, Urb, Urb, Rr, Rr, Urb, Urb, Xos, Urb, Rr, Rr, Urb, Urb, Xos, Urb, Urb, Rr, Rr, Urb, Urb, Xos, Xos, Xos, Xos, Xos, Xos, Xos, Xos, Xos, Urb, Xos, Urb, Urb, Rr, Rr, Xos, Urb, Xos, Xos, Urb^Dr, Xos, Xos
Xos, Xos, Xos, Xos, Xos, Urb, Xos, Xos, Xos, Iwr^Dr, Xos, Xos, Xos, Iwr, Xos, Urb, Rr, Xos, Xos, Xos, Urb, Urb, Rr, Urb, Urb, Chr, Urb, Xos, Urb, Xos, Xos, Xos, Xos, Urb, Urb, Rr, Rr, Urb, Urb, Urb, Rr, Urb, Urb, Urb, Urb, Rr, Urb, Urb, Xos, Xos, Xos, Xos, Xos, Xos, Chr, Xos, Xos, Xos, Xos, Xos, Xos, Xos, Xos, Urb, Rr, Rr, Rr, Urb, Urb, Xos, Xos, Xos
Xos, Xos, Xos, Xos, Xos, Xos, Xos, Xos, Xos, Iwr, Iwr, Iwr, Iwr, Iwr^Dr, Xos, Urb, Rr, Rr, Rr, Urb, Rr, Rr, Urb, Rr, Rr, Rr, Rr, Urb, Rr, Urb, Urb, Xos, Xos, Xos, Urb, Urb, Urb, Rr, Urb, Urb, Rr, Rr, Rr, Urb, Rr, Rr, Urb, Xos, Xos, Xos, Urb, Urb, Urb, Urb, Rr, Urb, Urb, Xos, Xos, Xos, Xos, Xos, Urb, Urb, Rr, Chr, Chr, Rr, Rr, Urb, Xos, Xos
Xos, Xos, Xos, Xos, Xos, Xos, Xos, Xos, Xos, Xos, Xos, Iwr, Xos, Xos, Xos, Urb, Urb, Urb, Urb, Rr, Urb, Urb, Xos, Urb, Urb, Chr, Urb, Rr, Urb, Rr, Rr, Urb, Urb, Urb, Urb, Urb, Rr, Rr, Rr, Rr, Urb, Urb, Urb, Rr, Rr, Urb, Urb, Urb, Urb, Urb, Rr, Rr, Rr, Rr, Chr, Rr, Rr, Urb, Urb, Xos, Urb, Urb, Rr, Rr, Rr, Chr, Khr, Chr, Chr, Urb, Xos, Xos
Xos, Xos, Xos, Xos, Xos, Xos, Xos, Xos, Xos, Xos, Xos, Xos, Xos, Xos, Xos, Xos, Xos, Xos, Xos, Urb, Xos, Xos, Xos, Xos, Xos, Xos, Xos, Urb, Xos, Urb, Urb, Rr, Rr, Urb, Rr, Rr, Chr, Urb, Urb, Urb, Chr, Urb, Urb, Urb, Chr, Rr, Rr, Urb, Rr, Rr, Xos, Xos, Xos, Urb, Xos, Urb, Urb, Rr, Rr, Urb, Rr, Rr, Urb, Rr, Rr, Chr, Chr, Chr, Rr, Urb, Xos, Xos
Xos, Xos, Xos, Xos, Xos, Xos, Xos, Xos, Xos, Xos, Xos, Xos, Xos, Xos, Xos, Xos, Xos, Xos, Xos, Xos, Xos, Xos, Xos, Xos, Xos, Xos, Xos, Xos, Xos, Xos, Xos, Urb, Urb, Rr, Urb, Urb, Rr, Rr, Rr, Chr, Chr, Chr, Rr, Rr, Rr, Urb, Urb, Rr, Urb, Xos, Xos, Xos, Xos, Xos, Xos, Xos, Xos, Urb, Urb, Rr, Urb, Urb, Xos, Urb, Urb, Chr, Rr, Rr^Vhcr, Rr, Urb, Xos, Xos
Xos, Xos, Xos, Xos, Xos, Xos, Xos, Xos, Xos, Xos, Xos, Xos, Xos, Xos, Xos, Xos, Xos, Xos, Xos, Xos, Xos, Xos, Xos, Xos, Xos, Xos, Xos, Xos, Xos, Xos, Xos, Xos, Xos, Urb, Chr, Chr, Chr, Urb, Rr, Urb, Rr, Urb, Rr, Urb, Chr, Chr, Chr, Urb, Xos, Xos, Xos, Xos, Xos, Xos, Xos, Xos, Xos, Xos, Xos, Urb, Xos, Xos, Xos, Xos, Xos, Urb, Urb, Rr, Urb, Urb, Xos, Xos
Xos, Xos, Xos, Xos, Xos, Xos, Xos, Xos, Xos, Xos, Xos, Xos, Xos, Xos, Xos, Xos, Xos, Xos, Xos, Xos, Xos, Xos, Xos, Xos, Xos, Xos, Xos, Xos, Xos, Xos, Xos, Xos, Xos, Xos, Urb, Rr, Urb, Chr, Chr, Urb, Rr, Urb, Chr, Chr, Urb, Rr, Urb, Xos, Xos, Xos, Xos, Xos, Xos, Xos, Xos, Xos, Xos, Xos, Xos, Xos, Xos, Xos, Xos, Xos, Xos, Xos, Xos, Urb, Xos, Xos, Xos, Xos
Xos, Xos, Xos, Xos, Xos, Xos, Xos, Xos, Xos, Xos, Xos, Xos, Xos, Xos, Xos, Xos, Xos, Xos, Xos, Xos, Xos, Xos, Xos, Xos, Xos, Xos, Xos, Xos, Xos, Xos, Xos, Xos, Xos, Xos, Urb, Rr, Urb, Urb, Urb, Urb, Rr, Urb, Urb, Urb, Urb, Rr, Urb, Xos, Xos, Xos, Xos, Xos, Xos, Xos, Xos, Xos, Xos, Xos, Xos, Xos, Xos, Xos, Xos, Xos, Xos, Xos, Xos, Xos, Xos, Xos, Xos, Xos
Xos, Xos, Xos, Xos, Xos, Xos, Xos, Xos, Xos, Xos, Xos, Xos, Xos, Xos, Xos, Xos, Xos, Xos, Xos, Xos, Xos, Xos, Xos, Xos, Xos, Xos, Xos, Xos, Xos, Xos, Xos, Xos, Xos, Xos, Urb, Rr, Urb, Urb, Urb, Urb, Rr, Urb, Urb, Urb, Urb, Rr, Urb, Xos, Xos, Xos, Xos, Xos, Xos, Xos, Xos, Xos, Xos, Xos, Xos, Xos, Xos, Xos, Xos, Xos, Xos, Xos, Xos, Xos, Xos, Xos, Xos, Xos
