Urb, Xos, Xos, Xos, Xos, Xos, Xos, Xos, Xos, Xos, Xos, Xos, Xos, Xos, Iwr, Iwr, Ch, Ch, Ch, Iwr, Iwr, Xos, Xos, Xos, Xos, Xos, Xos, Xos, Xos, Xos, Xos, Xos, Xos, Xos, Urb
Xos, Urb, Urb, Xos, Xos, Xos, Xos, Xos, Xos, Xos, Xos, Xos, Iwr, Iwr, Ch, Ch, Sm, Sm, Sm, Ch, Ch, Iwr, Iwr, Xos, Xos, Xos, Xos, Xos, Xos, Xos, Xos, Xos, Urb, Urb, Xos
Xos, Xos, Iwr, Iwr, Iwr, Iwr, Iwr, Iwr, Iwr, Iwr, Iwr, Iwr, Ch, Ch, Sm, Sm, Ww, Ww, Ww, Sm, Sm, Ch, Ch, Iwr, Iwr, Iwr, Iwr, Iwr, Iwr, Iwr, Iwr, Iwr, Iwr, Xos, Xos
Xos, Xos, Iwr, Iwr, Iwr, Iwr, Iwr, Iwr, Iwr, Iwr, Ch, Ch, Sm, Sm, Ww, Ww, Wwf, Wwf, Wwf, Ww, Ww, Sm, Sm, Ch, Ch, Iwr, Iwr, Iwr, Iwr, Iwr, Iwr, Iwr, Iwr, Xos, Xos
Xos, Xos, Iwr, Iwr, Iwr, Iwr, Iwr, Iwr, Ch, Ch, Sm, Ch, Sm, Ww, Wwf, Wwf, Ww, Ww, Ww, Wwf, Wwf, Ww, Sm, Ch, Sm, Ch, Ch, Iwr, Iwr, Iwr, Iwr, Iwr, Iwr, Xos, Xos
Xos, Xos, Iwr, Iwr, Iwr, Iwr, Ch, Ch, Sm, Sm, Ww, Sm, Sm, Ww, Wwf, Ww, Sm, Sm, Sm, Ww, Wwf, Ww, Sm, Sm, Ww, Sm, Sm, Ch, Ch, Iwr, Iwr, Iwr, Iwr, Xos, Xos
Xos, Xos, Iwr, Iwr, Ch, Ch, Sm, Sm, Ww, Ww, Wwf, Ww, Ww, Ww, Wwf, Ww, Sm, Ww, Sm, Ww, Wwf, Ww, Ww, Ww, Wwf, Ww, Ww, Sm, Sm, Ch, Ch, Iwr, Iwr, Xos, Xos
Xos, Xos, Iwr, Iwr, Ch, Sm, Ww, Ww, Wwf, Wwf, Ww, Wwf, Wwf, Wwf, Ww, Ww, Sm, Ww, Sm, Ww, Ww, Wwf, Wwf, Wwf, Ww, Wwf, Wwf, Ww, Ww, Sm, Ch, Iwr, Iwr, Xos, Xos
Xos, Xos, Iwr, Iwr, Ch, Sm, Ww, Wwf, Ww, Ww, Sm, Ww, Ww, Ww, Ww, Sm, Ww, Ww, Ww, Sm, Ww, Ww, Ww, Ww, Sm, Ww, Ww, Wwf, Ww, Sm, Ch, Iwr, Iwr, Xos, Xos
Xos, Xos, Iwr, Iwr, Ch, Sm, Ww, Wwf, Ww, Sm, Ww, Sm, Sm, Sm, Sm, Sm, Ww, Ww, Ww, Sm, Sm, Sm, Sm, Sm, Ww, Sm, Ww, Wwf, Ww, Sm, Ch, Iwr, Iwr, Xos, Xos
Xos, Xos, Iwr, Iwr, Ch, Sm, Ww, Wwf, Ww, Sm, Sm, Ww, Ww, Ww, Ww, Ww, Qxua, Ww, Qxua, Ww, Ww, Ww, Ww, Ww, Sm, Sm, Ww, Wwf, Ww, Sm, Ch, Iwr, Iwr, Xos, Xos
Xos, Xos, Iwr, Iwr, Ch, Sm, Ww, Wwf, Wwf, Ww, Ww, Sm, Ww, Ww, Ww, Qxua, Qxua, Gs, Qxua, Qxua, Ww, Ww, Ww, Sm, Ww, Ww, Wwf, Wwf, Ww, Sm, Ch, Iwr, Iwr, Xos, Xos
Xos, Xos, Iwr, Iwr, Ch, Sm, Sm, Ww, Ww, Wwf, Ww, Sm, Sm, Ww, Qxua, Gs, Gll^Fdf, Gll^Fdf, Gll^Fdf, Gs, Qxua, Ww, Sm, Sm, Ww, Wwf, Ww, Ww, Sm, Sm, Ch, Iwr, Iwr, Xos, Xos
Xos, Xos, Iwr, Iwr, Ch, Ch, Sm, Sm, Ww, Wwf, Ww, Ww, Sm, Ww, Qxua, Qxua, Gll^Fdf, 1 Gg^Fet, Gll^Fdf, Qxua, Qxua, Ww, Sm, Ww, Ww, Wwf, Ww, Sm, Sm, Ch, Ch, Iwr, Iwr, Xos, Xos
Xos, Xos, Iwr, Iwr, Ch, Sm, Ww, Ww, Wwf, Wwf, Ww, Sm, Ww, Ww, Ww, Gs, Qxua, Gll^Fdf, Qxua, Gs, Ww, Ww, Ww, Sm, Ww, Wwf, Wwf, Ww, Ww, Sm, Ch, Iwr, Iwr, Xos, Xos
Xos, Xos, Iwr, Iwr, Ch, Sm, Ww, Wwf, Ww, Ww, Sm, Sm, Ww, Ww, Ww, Qxua, Qxua, Gs, Qxua, Qxua, Ww, Ww, Ww, Sm, Sm, Ww, Ww, Wwf, Ww, Sm, Ch, Iwr, Iwr, Xos, Xos
Xos, Xos, Iwr, Iwr, Ch, Sm, Ww, Wwf, Ww, Sm, Ww, Ww, Sm, Ww, Sm, Ww, Ww, Ww, Ww, Ww, Sm, Ww, Sm, Ww, Ww, Sm, Ww, Wwf, Ww, Sm, Ch, Iwr, Iwr, Xos, Xos
Xos, Xos, Iwr, Iwr, Ch, Sm, Ww, Wwf, Ww, Sm, Sm, Sm, Ww, Sm, Ww, Sm, Ww, Ww, Ww, Sm, Ww, Sm, Ww, Sm, Sm, Sm, Ww, Wwf, Ww, Sm, Ch, Iwr, Iwr, Xos, Xos
Xos, Xos, Iwr, Iwr, Ch, Sm, Ww, Wwf, Wwf, Ww, Ww, Ww, Wwf, Ww, Ww, Sm, Sm, Ww, Sm, Sm, Ww, Ww, Wwf, Ww, Ww, Ww, Wwf, Wwf, Ww, Sm, Ch, Iwr, Iwr, Xos, Xos
Xos, Xos, Iwr, Iwr, Ch, Sm, Sm, Ww, Ww, Wwf, Wwf, Wwf, Ww, Wwf, Wwf, Ww, Sm, Ww, Sm, Ww, Wwf, Wwf, Ww, Wwf, Wwf, Wwf, Ww, Ww, Sm, Sm, Ch, Iwr, Iwr, Xos, Xos
Xos, Xos, Iwr, Iwr, Iwr, Ch, Ch, Sm, Sm, Ww, Ww, Ww, Sm, Ww, Wwf, Ww, Sm, Ww, Sm, Ww, Wwf, Ww, Sm, Ww, Ww, Ww, Sm, Sm, Ch, Ch, Iwr, Iwr, Iwr, Xos, Xos
Xos, Xos, Iwr, Iwr, Iwr, Iwr, Iwr, Ch, Ch, Sm, Sm, Sm, Sm, Ww, Wwf, Ww, Ww, Sm, Ww, Ww, Wwf, Ww, Sm, Sm, Sm, Sm, Ch, Ch, Iwr, Iwr, Iwr, Iwr, Iwr, Xos, Xos
Xos, Xos, Iwr, Iwr, Iwr, Iwr, Iwr, Iwr, Iwr, Ch, Ch, Ch, Sm, Ww, Ww, Wwf, Wwf, Ww, Wwf, Wwf, Ww, Ww, Sm, Ch, Ch, Ch, Iwr, Iwr, Iwr, Iwr, Iwr, Iwr, Iwr, Xos, Xos
Xos, Xos, Iwr, Iwr, Iwr, Iwr, Iwr, Iwr, Iwr, Iwr, Iwr, Ch, Ch, Sm, Sm, Ww, Ww, Wwf, Ww, Ww, Sm, Sm, Ch, Ch, Iwr, Iwr, Iwr, Iwr, Iwr, Iwr, Iwr, Iwr, Iwr, Xos, Xos
Xos, Xos, Xos, Iwr, Iwr, Iwr, Iwr, Iwr, Iwr, Iwr, Iwr, Iwr, Iwr, Ch, Ch, Sm, Sm, Ww, Sm, Sm, Ch, Ch, Iwr, Iwr, Iwr, Iwr, Iwr, Iwr, Iwr, Iwr, Iwr, Iwr, Xos, Xos, Xos
Xos, Xos, Urb, Urb, Xos, Xos, Xos, Xos, Xos, Xos, Xos, Xos, Xos, Iwr, Iwr, Ch, Ch, Sm, Ch, Ch, Iwr, Iwr, Xos, Xos, Xos, Xos, Xos, Xos, Xos, Xos, Xos, Urb, Urb, Xos, Xos
Xos, Urb, Xos, Xos, Xos, Xos, Xos, Xos, Xos, Xos, Xos, Xos, Xos, Xos, Xos, Iwr, Iwr, Ch, Iwr, Iwr, Xos, Xos, Xos, Xos, Xos, Xos, Xos, Xos, Xos, Xos, Xos, Xos, Xos, Urb, Xos
