Urb, Xos, Xos, Xos, Xos, Xos, Xos, Xos, Xos, Xos, Xos, Xos, Xos, Xos, Iwo, Iwo, Chr, Chr, Chr, Iwo, Iwo, Xos, Xos, Xos, Xos, Xos, Xos, Xos, Xos, Xos, Xos, Xos, Xos, Xos, Urb
Xos, Urb, Urb, Xos, Xos, Xos, Xos, Xos, Xos, Xos, Xos, Xos, Iwo, Iwo, Chr^Dr, Chr, Rb^Dr, Rb, Rb, Chr, Chr^Dr, Iwo, Iwo, Xos, Xos, Xos, Xos, Xos, Xos, Xos, Xos, Xos, Urb, Urb, Xos
Xos, Xos, Iwo, Iwo, Iwo, Iwo, Iwo, Iwo, Iwo, Iwo, Iwo, Iwo, Qxe, Chr, Rb, Rb, Wwg, Wwg, Wwg, Rb, Rb, Chr, Chr, Iwo, Iwo, Iwo, Iwo, Qxe, Iwo, Iwo, Iwo, Iwo, Iwo, Xos, Xos
Xos, Xos, Iwo, Iwo^Dr, Iwo, Iwo, Iwo^Dr, Iwo^Dr, Iwo^Dr, Iwo, Chr, Chr^Dr, Rb, Rb, Wwg, Wwg, Sm, Sm, Sm, Wwg, Wwg, Rb^Dr, Rb, Chr, Chr, Iwo, Iwo, Iwo, Iwo, Iwo, Iwo, Iwo, Iwo, Xos, Xos
Xos, Xos, Iwo^Dr, Iwo, Qxe, Iwo, Qxe, Iwr, Chr, Chr, Rb, Chr, Rb, Wwg, Sm, Sm, Qxe, Wwg, Wwg, Sm, Sm, Wwg, Rb, Chr^Dr, Rb, Chr, Chr, Iwo, Qxe, Iwo, Iwo, Iwo, Iwo, Xos, Xos
Xos, Xos, Iwo, Iwo, Iwo, Qxe, Wwg, Chr, Rb, Rb, Wwg, Rb, Rb, Wwg, Sm, Wwg, Qxe, Sm, Sm, Wwg, Sm, Qxe, Rb, Rb^Dr, Qxe, Rb, Rb, Chr, Chr, Iwo, Iwo, Iwo, Iwo, Xos, Xos
Xos, Xos, Iwo, Iwo, Chr, Chr, Qxu, Rb, Wwg, Wwg, Sm, Wwg, Wwf, Wwg, Qxe, Wwg, Sm, Wwg, Qxe, Wwg, Sm, Wwg, Wwg, Wwf, Sm, Wwg, Wwg, Rb, Rb, Chr, Chr^Dr, Iwo, Iwo^Dr, Xos, Xos
Xos, Xos, Iwo, Iwo^Dr, Chr, Rb, Wwg, Wwg, Sm, Sm, Wwg, Sm, Sm, Sm, Wwg, Wwg, Sm, Wwg, Sm, Wwg, Wwg, Sm, Sm, Sm, Wwf, Sm, Sm, Wwg, Wwg, Rb^Dr, Chr, Iwo, Iwo, Xos, Xos
Xos, Xos, Iwo, Iwo^Dr, Chr, Rb, Wwg, Qxe, Qxe, Wwg, Sm, Wwg, Wwf, Wwg, Qxe, Sm, Wwg, Wwg, Qxe, Sm, Wwg, Wwf, Wwg, Wwg, Sm, Wwg, Wwg, Sm, Wwg, Rb, Chr, Iwo, Iwo, Xos, Xos
Xos, Xos, Iwo, Iwo, Chr^Dr, Rb, Wwg, Sm, Wwg, Sm, Wwg, Sm, Qxe, Sm, Sm, Sm, Wwg, Wwg, Wwg, Sm, Sm, Sm, Qxe, Sm, Wwg, Sm, Wwg, Sm, Wwg, Qxe, Chr, Qxe, Iwo, Xos, Xos
Xos, Xos, Iwo, Iwo^Dr, Chr, Rb^Dr, Wwg, Sm, Wwg, Sm, Sm, Wwg, Wwg, Wwg, Wwf, Wwg, Qxua, Wwg, Qxua, Wwg, Wwg, Wwf, Wwg, Wwg, Sm, Sm, Wwg, Sm, Wwg, Rb, Chr, Iwr^Dr, Iwo, Xos, Xos
Xos, Xos, Iwo, Qxe, Qxe, Rb, Wwg, Sm, Sm, Wwg, Wwg, Sm, Wwg, Wwg, Wwf, Qxua, Qxua, Gd, Qxua, Qxua, Wwg, Wwg, Qxe, Sm, Qxe, Qxe, Sm, Qxe, Wwg, Rb, Chr, Iwr^Dr, Iwo, Xos, Xos
Xos, Xos, Iwo, Iwo, Chr, Rb, Rb, Wwg, Wwg, Sm, Wwg, Sm, Sm, Wwf, Qxua, Gd, Gll^Fdw, Gll^Fdw, Gll^Fdw, Gd, Qxua, Wwg, Sm, Sm, Wwg, Sm, Wwg, Wwg, Qxe, Rb, Chr^Dr, Iwo, Iwo, Xos, Xos
Xos, Xos, Iwo, Iwo^Dr, Chr, Chr, Rb, Rb, Wwg, Sm, Qxe, Wwg, Sm, Wwg, Qxua, Qxua, Gll^Fdw, 1 Gg^Fet, Gll^Fdw, Qxua, Qxua, Wwg, Sm, Wwg, Qxe, Sm, Wwg, Qxe, Rb, Chr, Chr, Iwr^Dr, Iwo, Xos, Xos
Xos, Xos, Iwo, Iwo, Chr, Rb, Wwg, Wwg, Sm, Sm, Wwg, Sm, Wwg, Wwg, Wwg, Gd, Qxua, Gll^Fdw, Qxua, Gd, Wwg, Wwg, Wwf, Sm, Wwg, Qxe, Qxe, Wwg, Wwg, Rb, Chr, Iwo, Iwo, Xos, Xos
Xos, Xos, Iwo, Iwo, Chr^Dr, Rb, Wwf, Qxe, Wwf, Wwg, Sm, Sm, Wwg, Wwg, Wwg, Qxua, Qxua, Gd, Qxua, Qxua, Wwg, Wwg, Qxe, Sm, Sm, Wwg, Wwg, Sm, Wwg, Rb, Chr, Iwr^Dr, Qxe, Xos, Xos
Xos, Xos, Iwo, Iwo^Dr, Chr, Rb, Wwg, Sm, Wwg, Sm, Wwg, Wwf, Qxe, Wwg, Sm, Wwg, Wwf, Wwg, Wwg, Wwg, Sm, Wwg, Sm, Wwg, Wwg, Sm, Wwg, Sm, Wwg, Qxe, Chr, Qxe, Qxe, Qxe, Xos
Xos, Xos, Iwo, Iwo, Chr, Rb, Wwg, Qxe, Qxe, Sm, Sm, Sm, Qxe, Sm, Wwg, Sm, Wwg, Wwf, Qxe, Sm, Qxe, Sm, Wwg, Sm, Qxe, Sm, Wwg, Sm, Wwg, Rb, Chr, Iwo, Iwo, Xos, Xos
Xos, Xos, Iwo, Iwo, Chr, Rb, Wwg, Qxe, Sm, Wwg, Wwf, Wwg, Sm, Wwg, Wwg, Sm, Sm, Wwf, Sm, Sm, Wwg, Wwg, Sm, Wwg, Wwg, Wwg, Sm, Sm, Wwg, Rb, Chr, Iwo^Dr, Iwo, Xos, Xos
Xos, Xos, Iwo, Iwo^Dr, Chr, Rb, Rb, Wwg, Qxe, Qxe, Sm, Sm, Wwg, Sm, Sm, Wwg, Sm, Wwg, Sm, Wwg, Sm, Sm, Wwf, Sm, Sm, Sm, Wwg, Wwg, Rb, Wwg, Chr, Iwo, Iwo, Xos, Xos
Xos, Xos, Iwo, Iwo, Iwo, Chr, Chr, Qxe, Rb, Wwg, Wwg, Wwg, Rb^Dr, Qxe, Sm, Wwg, Sm, Wwg, Sm, Wwf, Qxe, Wwg, Rb, Wwg, Wwg, Wwg, Rb, Qxe, Chr, Chr, Iwo, Iwo, Qxe, Qxe, Xos
Xos, Xos, Iwo, Iwo, Iwo, Iwo^Dr, Iwo, Chr, Chr, Rb, Rb, Rb, Rb, Wwg, Sm, Qxe, Wwg, Sm, Wwg, Wwg, Sm, Wwg, Rb, Rb, Rb, Rb, Chr, Chr^Dr, Iwo, Iwo, Iwo^Dr, Iwo, Iwo, Xos, Xos
Xos, Xos, Qxe, Iwo, Iwo, Iwo, Iwo^Dr, Iwo, Iwo, Qxe, Chr, Chr, Rb, Wwg, Wwg, Sm, Sm, Wwf, Sm, Sm, Wwg, Wwg, Rb, Chr, Chr, Chr, Iwo, Iwo, Iwo, Iwo, Iwo^Dr, Iwo, Iwo, Xos, Xos
Xos, Xos, Iwo, Iwo, Iwo, Qxe, Iwo, Iwo, Iwo, Iwo^Dr, Iwo, Chr, Chr, Rb, Wwf, Wwg, Wwg, Sm, Wwg, Wwg, Rb, Rb, Chr, Chr, Iwo^Dr, Iwo, Iwo, Iwo, Iwo, Iwo, Iwo, Iwo, Iwo, Xos, Xos
Xos, Xos, Xos, Iwo, Iwo, Iwo, Iwo^Dr, Iwo^Dr, Iwo, Qxe, Iwo, Iwo, Iwo, Chr, Qxe, Rb, Rb, Wwf, Rb, Rb, Chr, Chr, Iwo, Iwo, Iwo, Iwo, Iwo, Iwo, Qxe, Iwo, Iwo, Iwo^Dr, Xos, Xos, Xos
Xos, Xos, Urb, Urb, Xos, Xos, Xos, Xos, Xos, Xos, Xos, Xos, Xos, Iwo, Iwo, Chr, Chr, Rb, Chr, Chr, Iwo, Iwo, Qxe, Qxe, Xos, Xos, Xos, Xos, Xos, Xos, Xos, Urb, Urb, Xos, Xos
Xos, Urb, Xos, Xos, Xos, Xos, Xos, Xos, Xos, Xos, Xos, Xos, Xos, Xos, Xos, Iwo, Iwo, Chr, Iwo, Iwo, Xos, Xos, Xos, Qxe, Qxu, Xos, Xos, Xos, Xos, Xos, Xos, Xos, Xos, Urb, Xos
