Xos, Xos, Xos, Xos, Xos, Xos, Xos, Xos, Xos, Xos, Xos, Xos, Xos, Uue, Xos, Xos, Xos, Xos, Urb, Xos, Xos, Xos, Xos, Xos, Xos, Xos, Xos, Xos, Xos, Xos, Xos, Xos, Xos, Xos, Xos, Xos, Xos, Xos, Xos
Xos, Xos, Xos, Xos, Xos, Xos, Xos, Xos, Xos, Xos, Xos, Xos, Xos, Xos, Xos, Xos, Urb, Urb, Xu, Urb, Urb, Xos, Xos, Xos, Xos, Xos, Xos, Xos, Xos, Xos, Xos, Xos, Xos, Xos, Xos, Xos, Xos, Xos, Xos
Xos, Xos, Xos, Xos, Xos, Xos, Xos, Xos, Xos, Xos, Xos, Urb, Urb, Xos, Urb, Urb, Urb, Xu, Wog, Xu, Urb, Urb, Urb, Urb, Urb^Dr, Xos, Xos, Xos, Xos, Xos, Xos, Xos, Xos, Xos, Xos, Xos, Xos, Xos, Xos
Xos, Xos, Xos, Xos, Xos, Xos, Xos, Xos, Xos, Xos, Urb, Urb, Urb, Urb^Dr, Urb^Dr, Urb, Urb, Xu, Xu, Xu, Urb, Urb^Dr, Urb^Dr, Urb, Urb, Xos, Urb, Xos, Xos, Xos, Xos, Xos, Xos, Xos, Xos, Xos, Xos, Xos, Xos
Xos, Xos, Xos, Xos, Urb, Xos, Urb, Xos, Urb, Urb, Urb, Urb^Dr, Urb, Urb, Urb^Edt, Urb, Re, Re, Gd^Edb, Re, Re, Urb^Edt, Urb, Urb, Urb^Edt, Urb, Urb, Urb, Urb, Qxe, Qxe, Xos, Xos, Xos, Xos, Xos, Xos, Xos, Xos
Xos, Xos, Xos, Xos, Urb, Urb, Urb, Urb, Urb, Urb, Rr, Rr, Rr, Urb, Re, Gd, Rb, Gd, Wwg, Rb, Gll, Re, Re, Urb, Rr, Rr, Rr, Urb, Urb, Qxe, Qxe, Xos, Xos, Xos, Xos, Xos, Xos, Xos, Xos
Xos, Xos, Xos, Xos, Urb, Urb, Qxe, Urb, Urb^Dr, Urb, Rr, Chr, Re, Gll^Edb, Gd, Rb^Edb, Wwg, Wwg, Wwg, Wwf, Wwg, Gll, Gd^Edb, Re^Edb, Re, Chr, Rr, Urb, Urb, Urb, Urb, Xos, Xos, Xos, Xos, Xos, Xos, Xos, Xos
Xos, Xos, Xos, Xos, Urb, Urb^Dr, Urb, Urb, Urb, Urb, Urb, Rr, Gll, Rb, Wwf, Wwg, Wwf, Sm^Edb, Wwg, Wwg, Sm, Wwf, Wwg, Gd^Edb, Re, Rr, Urb, Urb^Dr, Urb, Urb, Urb, Xos, Xos, Xos, Xos, Xos, Xos, Xos, Xos
Xos, Xos, Xos, Xos, Urb, Urb, Urb^Dr, Urb, Qxe, Urb^Edt, Qxe, Urb^Edb, Re, Gll, Wwg, Sm, Wwg, Wwf, Rb, Wwf, Wwg, Wwg, Wwg, Gll, Re, Urb, Urb, Urb, Urb^Edt, Urb^Dr, Urb, Xos, Xos, Xos, Xos, Xos, Xos, Xos, Xos
Xos, Xos, Xos, Urb, Urb, Urb, Qxe, Urb, Urb, Urb, Urb, Urb, Gd, Rb, Wwg, Wwg, Wwf, Rb, Re, Rb, Wwf, Sm^Edb, Wwf, Gll, Gll, Urb, Qxe, Urb, Urb, Urb, Urb, Urb, Xos, Xos, Xos, Xos, Xos, Xos, Xos
Xos, Xos, Xos, Urb, Urb, Qxe, Urb, Urb, Urb^Dr, Urb, Urb^Dr, Urb^Edt, Gll, Rb, Wwg, Sm^Edb, Wwg, Rb, Rb, Rb, Wwf, Wwg, Wwg, Rb, Gd, Urb, Urb, Urb, Urb^Dr, Qxe, Qxe, Urb, Urb, Xos, Xos, Xos, Xos, Xos, Xos
Xos, Xos, Xos, Xos, Urb, Urb, Urb, Urb^Dr, Urb, Urb, Urb, Urb, Re, Rb^Edb, Wwg, Wwg, Sm, Wwg, Wwf, Wwg, Wwg, Wwg, Wwg, Gd, Re^Edb, Urb^Dr, Urb, Urb, Urb^Dr, Urb, Urb, Urb, Urb, Xos, Xos, Xos, Xos, Xos, Xos
Xos, Xos, Xos, Xos, Urb, Urb, Urb^Dr, Urb, Qxe, Urb, Rr, Rr, Gd, Rb, Rb, Wwf, Wwg, Wwf^Edb, Wwg, Sm^Edb, Wwg, Wwg, Rb, Rb, Re, Rr, Rr, Urb, Urb, Urb, Qxe, Qxe, Urb, Xos, Xos, Xos, Xos, Xos, Xos
Xos, Xos, Xos, Xos, Xos, Urb, Urb, Urb, Qxe, Urb, Rr, Chr, Rr, Gd, Re^Edb, Rb^Edb, Rb, Wwg, Wwg, Wwf, Gd, Rb, Re, Gd, Rr, Chr, Rr, Urb, Urb, Urb, Qxe, Urb^Dr, Urb, Xos, Xos, Xos, Xos, Xos, Xos
Xos, Xos, Xos, Xos, Xos, Urb, Urb, Urb, Qxe, Urb, Urb, Rr, Urb^Edt, Urb, Urb^Dr, Gll, Gll, Rb, Rb, Rb, Re, Re^Edb, Urb, Urb, Urb^Edt, Rr, Urb, Urb, Urb, Urb, Urb, Urb, Xos, Xos, Xos, Xos, Xos, Xos, Xos
Xos, Xos, Xos, Xos, Xos, Xos, Xos, Urb, Urb^Dr, Urb, Urb, Urb, Urb, Urb, Urb^Dr, Urb, Urb, Re, Re, Gll, Urb, Urb, Urb^Dr, Qxe, Urb^Dr, Urb^Dr, Urb, Urb^Dr, Urb^Dr, Urb, Urb, Urb, Xos, Xos, Xos, Xos, Xos, Xos, Xos
Xos, Xos, Xos, Xos, Xos, Xos, Urb, Urb, Urb, Urb, Urb^Dr, Urb, Qxe, Urb, Urb, Qxe, Urb, 1 Urb, Urb, Urb, Urb, Urb, Urb, Urb, Urb, Urb, Qxe, Urb, Urb, Qxe, Xos, Xos, Xos, Xos, Xos, Xos, Xos, Xos, Xos
Xos, Xos, Xos, Xos, Xos, Xos, Xos, Urb, Xos, Urb, Urb, Urb, Urb, Urb, Urb^Dr, Urb, Rr, Urb, Urb, Urb, Rr, Urb, Qxe, Urb, Urb, Urb, Xos, Urb, Xos, Xos, Xos, Xos, Xos, Xos, Xos, Xos, Xos, Xos, Xos
Xos, Xos, Xos, Xos, Xos, Xos, Xos, Xos, Xos, Xos, Xos, Xos, Xos, Urb, Xos, Rr, Xos, Rr, Urb, Rr, Xos, Rr, Xos, Xos, Xos, Xos, Xos, Xos, Xos, Xos, Xos, Xos, Xos, Xos, Xos, Xos, Xos, Xos, Xos
Xos, Xos, Xos, Xos, Xos, Xos, Xos, Xos, Xos, Xos, Xos, Xos, Xos, Xos, Xos, Xos, Xos, Rr, Urb, Rr, Xos, Xos, Xos, Xos, Xos, Xos, Xos, Xos, Xos, Xos, Xos, Xos, Xos, Xos, Xos, Xos, Xos, Xos, Xos
Xos, Xos, Xos, Xos, Xos, Xos, Xos, Xos, Xos, Xos, Xos, Xos, Xos, Xos, Xos, Xos, Xos, Rr, Urb, Rr, Xos, Xos, Xos, Xos, Xos, Xos, Xos, Xos, Xos, Xos, Xos, Xos, Xos, Xos, Xos, Xos, Xos, Xos, Xos
Xos, Xos, Xos, Xos, Xos, Xos, Xos, Xos, Xos, Xos, Xos, Xos, Xos, Xos, Xos, Xos, Xos, Rr, Urb, Rr, Xos, Xos, Xos, Xos, Xos, Xos, Xos, Xos, Xos, Xos, Xos, Xos, Xos, Xos, Xos, Xos, Xos, Xos, Xos
Xos, Xos, Xos, Xos, Xos, Xos, Xos, Xos, Xos, Xos, Xos, Xos, Xos, Xos, Xos, Xos, Xos, Rr, Urb, Rr, Xos, Xos, Xos, Xos, Xos, Xos, Xos, Xos, Xos, Xos, Xos, Xos, Xos, Xos, Xos, Xos, Xos, Xos, Xos
Xos, Xos, Xos, Xos, Xos, Xos, Xos, Xos, Xos, Xos, Xos, Xos, Xos, Xos, Xos, Xos, Xos, Rr, Urb, Rr, Xos, Xos, Xos, Xos, Xos, Xos, Xos, Xos, Xos, Xos, Xos, Xos, Xos, Xos, Xos, Xos, Xos, Xos, Xos
Xos, Xos, Xos, Xos, Xos, Xos, Xos, Xos, Xos, Xos, Xos, Xos, Xos, Xos, Xos, Xos, Xos, Rr, Urb, Rr, Xos, Xos, Xos, Xos, Xos, Xos, Xos, Xos, Xos, Xos, Xos, Xos, Xos, Xos, Xos, Xos, Xos, Xos, Xos
Xos, Xos, Xos, Xos, Xos, Xos, Xos, Xos, Xos, Xos, Xos, Xos, Xos, Xos, Xos, Xos, Xos, Rr, Urb, Rr, Xos, Xos, Xos, Xos, Xos, Xos, Xos, Xos, Xos, Xos, Xos, Xos, Xos, Xos, Xos, Xos, Xos, Xos, Xos
Xos, Xos, Xos, Xos, Xos, Xos, Xos, Xos, Xos, Xos, Xos, Xos, Xos, Xos, Xos, Xos, Xos, Rr, Urb, Rr, Xos, Xos, Xos, Xos, Xos, Xos, Xos, Xos, Xos, Xos, Xos, Xos, Xos, Xos, Xos, Xos, Xos, Xos, Xos
