Xu, Xu, Xu, Xu, Xu, Xu, Xu, Xu, Xu, Xu, Xu, Xu, Xu, Xu, Xu, Xu, Xu, Xu, Xu, Xu, Uh, Uu, Uu, Uu, Ur, Uh, Uh, Uu, Uu, Uu, Uu, Xu, Xu, Xu, Xu, Xu, Xu, Xu, Wo, Wo, Wo, Xu
Xu, Xu, Xu, Xu, Xu, Xu, Xu, Xu, Xu, Xu, Xu, Xu, Xu, Xu, Xu, Xu, Xu, Xu, Xu, Xu, Xu, Uu, Uh, Uu, Uu, Ur^Ii, Ur, Uu, Uh, Uh, Xu, Xu, Xu, Xu, Xu, Xu, Xu, Xu, Wo, Wo, Wo, Ww
Xu, Xu, Xu, Xu, Xu, Xu, Xu, Xu, Xu, Xu, Wo, Xu, Wo, Xu, Ww, Xu, Ww, Xu, Xu, Xu, Xu, Xu, Xu, Uu, Wwf, Uu, Ur, Uh, Uu, Xu, Xu, Xu, Xu, Xu, Xu, Xu, Xu, Xu, Ww, Ww, Ww, Xu
Xu, Xu, Xu, Xu, Xu, Xu, Xu, Xu, Xu, Wo, Ww, Wo, Ww, Wo, Ww, Ww, Ww, Ww, Ww, Ww, Ww, Xu, Xu, Xu, Ss, Wwf, Wwf, Uu, Wwf, Xu, Xu, Xu, Xu, Xu, Xu, Xu, Xu, Xu, Ww, Ww, Xu, Xu
Xu, Xu, Xu, Xu, Xu, Xu, Xu, Xu, Wo, Wo, Ww, Ww, Ww, Ww, Xu, Ww, Xu, Ww, Ww, Ww, Ww, Ww, Wwf, Sm, Wwf, Ss, Wwf, Wwf, Ss, Sm, Ss, Xu, Xu, Xu, Xu, Xu, Ww, Ww, Ww, Ww, Xu, Xu
Xu, Xu, Xu, Xu, Xu, Xu, Xu, Wo, Ww, Ww, Xu, Xu, Xu, Xu, Xu, Xu, Xu, Xu, Ur, Uh, Ww, Wwf, Ww, Sm, Sm, Sm, Sm, Wwf, Chw, Sm, Sm, Ss, Wwf, Xu, Ww, Ww, Ww, Ww, Xu, Xu, Xu, Xu
Xu, Xu, Xu, Xu, Xu, Xu, Xu, Xu, Ww, Ww, Xu, Xu, Xu, Xu, Uu^Tf, Uu^Vu, Uh, Ur, Uu, Uu, Uu, Uu, Xu, Ww, Ww, Wwf, Sm, Chs, 5 Khw, Chs, Wwf, Sm, Wwf, Wwf, Ww, Ww, Xu, Xu, Xu, Xu, Xu, Xu
Xu, Xu, Xu, Xu, Xu, Xu, Xu, Xu, Ww, Ww, Ww, Xu, Xu, Uh, Uh, Uh, Uu, Uu, Uu, Uu, Xu, Xu, Xu, Xu, Ww, Wwf, Ss, Chw, Chw, Chs, Ss, Ss, Ww, Ww, Uu, Uu, Uu, Xu, Xu, Xu, Xu, Xu
Xu, Xu, Xu, Xu, Xu, Xu, Xu, Xu, Xu, Ww, Ww, Xu, Xu, Uu, Ur, Ur, Uu^Tf, Uu^Tf, Xu, Xu, Xu, Xu, Xu, Xu, Xu, Ww, Ww, Wwf, Wwf, Sm, Ss, Wwf, Ww, Uu, Uu, Ur, Uu, Xu, Xu, Xu, Xu, Xu
Xu, Xu, Xu, Xu, Xu, Xu, Xu, Xu, Xu, Ww, Ww, Ww, Ww, Wwf, Ww, Uu, Xu, Xu, Xu, Xu, Xu, Xu, Xu, Xu, Xu, Xu, Xu, Ww, Ww, Ww, Ww, Ww, Xu, Xu, Ur, Ur, Uu, Xu, Xu, Xu, Xu, Xu
Xu, Xu, Xu, Xu, Xu, Xu, Xu, Xu, Xu, Xu, Xu, Ww, Ww, Wwf, Wwf, Ww, Ww, Xu, Xu, Xu, Xu, Xu, Xu, Xu, Xu, Xu, Xu, Xu, Xu, Ww, Xu, Xu, Uu^Vu, Ur, Xu, Xu, Xu, Ur, Xu, Xu, Xu, Xu
Xu, Xu, Xu, Xu, Xu, Xu, Xu, Xu, Xu, Xu, Xu, Xu, Uu, Ww, Uu, Ww, Ww, Ww, Ww, Xu, Wo, Xu, Xu, Xu, Xu, Xu, Xu, Xu, Xu, Xu, Xu, Xu, Uh, Uh, Uu, Xu, Uu, Ur, Xu, Xu, Xu, Xu
Xu, Xu, Xu, Xu, Xu, Xu, Xu, Xu, Xu, Xu, Xu, Uh, Uu, Ur, Ur, Uu^Tf, Uu, Ww, Ww, Ww, Ww, Wo, Wo, Xu, Xu, Xu, Xu, Xu, Xu, Xu, Uu^Tf, Uh, Uu, Uu, Xu, Uu, Xu, Xu, Xu, Xu, Xu, Xu
Xu, Xu, Xu, Xu, Xu, Xu, Xu, Xu, Xu, Xu, Xu, Uh, Uu, Uu^Vu, Ur, Uu, Uh, Xu, Xu, Ww, Ww, Ww, Ww, Wo, Wo, Xu, Xu, Xu, Xu, Xu, Uh, Uu, Xu, Xu, Uu^Tf, Ur, Xu, Xu, Xu, Xu, Xu, Xu
Xu, Xu, Xu, Xu, Xu, Xu, Xu, Xu, Xu, Xu, Md^Xm, Xu, Xu, Ur, Uu, Uh, Xu, Xu, Xu, Xu, Xu, Ww, Ww, Wo, Xu, Xu, Xu, Xu, Xu, Xu, Uu, Uu, Uu^Vu, Xu, Uh, Ur, Xu, Xu, Xu, Xu, Xu, Xu
Md^Xm, Xu, Md^Xm, Md^Xm, Md^Xm, Md^Xm, Md^Xm, Md^Xm, Md^Xm, Md^Xm, Hhd, Md^Xm, Md^Xm, Ur, Re, Md^Xm, Md^Xm, Xu, Xu, Xu, Xu, Xu, Ww, Ww, Xu, Xu, Xu, Xu, Xu, Xu, Xu, Uu, Uu, Uu, Uu, Ur, Xu, Xu, Xu, Xu, Xu, Xu
Hhd, Md^Xm, Hhd, Hhd, Md, Hhd, Hhd, Hhd, Hhd, Hhd, Md, Hhd, Hhd, Re, Re, Hhd, Hhd, Md^Xm, Md^Xm, Xu, Xu, Xu, Ww, Xu, Xu, Xu, Xu, Xu, Xu, Xu, Xu, Uu, Xu, Ur, Ur, Uu, Xu, Xu, Xu, Xu, Xu, Xu
Hhd, Hhd, Md, Hhd, Md, Hhd, Hh, Md, Md, Hhd, Hh, Md, Md, Re, Re, Hhd, Hhd, Hhd, Hhd, Md^Xm, Md^Xm, Ww, Ww, Xu, Xu, Xu, Xu, Xu, Xu, Xu, Xu, Xu, Xu, Xu, Ur, Uu, Xu, Xu, Xu, Xu, Xu, Xu
Hhd, Md, Hh, Md, Hhd, Hhd, Hhd, Hh, Hhd, Hh, Hhd, Hhd, Hhd, Md, Re, Re, Md, Md, Hhd, Hhd, Ww, Ww, Ww, Md^Xm, Md^Xm, Xu, Xu, Xu, Xu, Xu, Xu, Xu, Xu, Uu^Tf, Uu, Uu, Xu, Xu, Xu, Xu, Xu, Xu
Hhd, Hh, Hh, Hh, Hh^Vc, Hhd, Hh, Hhd, Hhd, Hhd, Hh^Vc, Hh, Hhd, Hhd, Re, Hhd, Hhd, Md, Hh, Hhd, Ww, Ww, Hhd, Hhd, Hhd, Md^Xm, Md^Xm, Xu, Xu, Xu, Xu, Xu, Xu, Ur, Uu, Xu, Xu, Xu, Xu, Xu, Xu, Xu
Hhd, Hh, Hhd, Hh, Hhd, Hhd, Hhd, Hh, Hh, Hh, Hh, Hhd, Hhd, Hhd, Ww, Re, Ww, Hh, Ww, Ww, Ww, Ww, Hhd, Hhd, Hhd, Hhd, Md^Xm, Xu, Md^Xm, Xu, Xu, Xu, Xu, Uh, Uu, Ur, Xu, Xu, Xu, Xu, Xu, Xu
Hhd, Md, Hhd, Hh, Hhd, Hhd, Hhd, Hhd, Hhd, Hh, Hhd, Hhd, Ww, Ww, Ww, Ww^Bw|, Re, Ww, Ww, Ww, Ss, Ss, Md, Md, Hhd, Hhd, Hhd, Md^Xm, Hhd, Md^Xm, Md^Xm, Xu, Xu, Xu, Ur, Uu^Tf, Xu, Xu, Xu, Xu, Xu, Xu
Hhd, Md, Md, Md, Hh, Md, Hhd, Hhd, Hhd, Hhd, Ww, Ww, Hh, Hhd, Hhd, Re, Ss, Ss, Ww, Hh, Hh, Hh, Hh^Vc, Hhd, Hhd, Md, Hhd^Vhhr, Hhd, Hhd, Hhd, Hhd, Md^Xm, Rd, Uu, Ur, Uh, Xu, Xu, Xu, Xu, Xu, Xu
Hhd, Hhd, Hhd, Hh, Hhd, Hhd, Re, Hhd, Ww, Ww, Ss, Hh, Chr, Hh^Vc, Hhd, Hhd, Ss, Ss, Ww, Hh, Ss, Ss, Ss, Hhd, Chw, Hhd, Hhd, Md, Rd, Hhd, Rd, Rd, Hhd, Ur, Md^Xm, Xu, Xu, Xu, Xu, Xu, Xu, Xu
Hhd, Hhd, Hhd, Hh^Vc, Hhd, Hhd, Hhd, Ww, Ss, Ss, Ss^Vhs, Chw, 2 Khr, Chr, Re, Hh, Ss, Hh^Vc, Ww, Ss, Hhd, Ss, Sm, Chw, 3 Khw, Chr, Hh, Hhd, Rd, Re, Hh, Hhd, Hhd, Hhd, Hhd, Md^Xm, Xu, Xu, Xu, Xu, Xu, Xu
Hhd, Md, Hh, Hh, Hh, Hhd, Hhd, Ww, Ww, Re, Hhd, Chw, Chr, Chr, Re, Hhd, Hhd, Hh, Ww, Hhd, Hh^Vc, Hh, Hhd, Chw, Hh^Vc, Hh, Re, Rd, Hhd, Hhd, Hh, Hh^Vc, Hhd, Hhd, Hhd, Md^Xm, Md^Xm, Xu, Xu, Xu, Xu, Xu
Hhd, Hh, Hh, Hh, Hh, Hh, Hhd, Ww, Ww, Chw, Ww, Hh, Hh, Hh, Ss, Ss, Ww, Ww, Ss, Ss, Hhd, Hhd, Hh, Chr, Hh, Hhd, Re, Hhd, Chw, Chr, Chw, Hhd, Chr, Hhd, Hhd, Hhd, Hhd, Md^Xm, Xu, Xu, Xu, Xu
Hhd, Hh, Hhd^Vhhr, Hh, Hhd, Hh, Md, Hhd, Hh, Ww, Rd, Ww^Bw/, Ww, Ww, Ww, Ww, Ww, Ww, Ww, Hhd, Rd, Hhd, Rd, Hh, Re, Rd, Ww, Ww, Hhd^Vc, Hhd, 4 Khw, Chw, Hhd, Hhd^Vct, Hhd, Hhd, Md^Xm, Md^Xm, Xu, Xu, Xu, Xu
Hhd, Hhd, Hh, Hhd, Hhd, Hhd, Md, Hhd, Hhd, Hhd, Rd, Hhd, Hhd, Hhd, Hhd, Hhd, Hhd, Hhd, Hh, Ww, Rd, Rd, Re, Rd, Re, Re, Ww, Ss, Ss, Hhd, Ww, Hh, Hh, Hhd, Hhd, Hhd, Hhd, Md^Xm, Xu, Xu, Xu, Xu
Hhd, Hhd, Hh, Md, Hhd, Hhd, Hh, Hh, Hh, Hhd, Hhd, Rd, Rd, Rd, Rd, Hhd, Hh, Hhd, Rd, Ww^Bw/, Ww, Hhd, Ww, Ss, Ww, Ss, Ss, Ss, Ww, Ww, Hh, Rd, Rd, Hhd, Hh, Hhd, Hhd, Md^Xm, Xu, Xu, Xu, Xu
Hhd, Md, Hhd, Md, Hhd, Hh, Hh, Hhd^Vhhr, Hh, Hhd, Rd, Rd, Hhd, Hh, Hhd, Rd, Rd, Rd, Rd, Hhd, Hh, Ww, Ww, Ww, Wo, Ww, Wo, Ww, Ww, Ww, Hhd^Vct, Hh, Rd, Rd, Hhd, Mm, Hhd, Md^Xm, Xu, Xu, Xu, Xu
Hhd, Hh, Hhd, Hh, Hhd, Hh, Hh, Hhd, Hhd, Hhd, Rd, Hhd, Hhd, Hh, Hhd, Hhd, Rd, Hhd, Hh, Hh, Re, Ss, Ww, Ww, Wo, Wo, Wo, Ww, Ww, Ww, Hhd, Hh, Rd, Hhd, Hhd, Mm, Hhd, Md^Xm, Md^Xm, Xu, Xu, Xu
Hd, Hhd, Hhd, Hhd, Hhd, Hhd, Hhd, Hhd, Hhd, Hhd, Rd, Hhd, Hhd, Hhd, Hh, Rd, Hhd, Hhd, Hhd, Hhd, Re^Vct, Ss, Ww, Ww, Wo, Wo, Wo, Wo, Ww, Ww, Hh, Rd, Md, Md, Hhd, Mm, Mm, Hhd, Md^Xm, Xu, Xu, Xu
Hd, Hd, Hd, Hhd, Hd, Hhd, Hd, Hhd, Rd, Rd, Hhd, Hhd, Hhd, Hhd, Hhd^Vct, Rd, Rd, Hhd, Hh, Hhd, Hh, Ss, Ss, Ww, Ww, Ww, Ww, Ww, Ww, Ww, Re, Rd, Md, Hhd, Md, Mm, Hhd, Mm, Md^Xm, Xu, Xu, Xu
Dd, Hd, Hd, Hd, Hd, Hd, Dd, Hd, Rd, Rd, Hhd, Hhd, Hhd, Hh, Hh, Hhd, Hhd, Rd, Rd, Hh, Hh, Hh, Hhd, Ss, Re, Ww, Ss, Ww, Hh, Re, Hh, Hh, Hhd, Hh, Hh, Hhd, Hhd, Hhd, Hhd, Md^Xm, Xu, Xu
Dd, Dd, Dd, Hd, Dd, Hd, Rd, Rd, Dd, Hhd, Hhd, Hhd, Hhd, Hhd, Hh, Hh, Hhd, Hhd, Rd, Mm, Rd, Rd, Rd, Re, Rd, Re, Re, Hhd, Hhd, Re, Mm, Hhd, Hh, Hh, Md, Hh, Hh, Hh, Md^Xm, Md^Xm, Xu, Xu
Dd, Dd^Vdt, Dd, Dd, Ce, Rd, Rd, Dd, Dd, Hhd, Hhd, Hhd, Hh, Hhd, Hhd, Mm, Hh, Hhd, Hhd, Rd, Hh, Mm, Hhd, Rd, Mm, Hhd^Vhhr, Hhd, Rd, Rd, Rd, Mm, Hh, Hh, Hh, Hh, Md, Hh, Hhd, Hh, Md^Xm, Xu, Xu
Dd, Dd, Dd, Ce, 1 Ke, Ce, Rd, Dd, Dd, Hd, Hd, Hhd, Hhd, Hh, Hh, Hhd, Mm, Hhd, Hh, Mm, Hh, Mm, Hhd, Hh, Mm, Mm, Hh, Mm, Mm, Mm, Hh, Hhd, Hh, Hh, Hh, Hhd, Mm, Hh, Hhd, Md^Xm, Xu, Xu
Dd, Dd, Dd, Ce, Ce, Ce, Dd, Dd^Vdt, Dd, Hd, Hd, Hhd, Hhd, Hh, Hh, Hhd, Hhd, Mm, Mm, Mm, Mm, Hhd, Mm, Mm, Mm, Mm, Hhd, Mm, Hh, Hh, Hh, Hh, Mm, Hhd, Mm, Hhd, Mm, Hhd, Hhd, Md^Xm, Xu, Xu
Dd, Dd, Dd^Vdt, Dd, Dd, Dd, Dd, Hd, Dd, Dd, Hd, Hd, Hhd, Hhd, Hh, Hhd, Hhd, Hh, Mm, Mm, Mm, Hh, Hhd, Hhd, Hhd, Hhd, Hh, Hhd, Hhd, Hhd, Mm, Mm, Mm, Hhd, Hh, Hhd, Hhd, Hhd, Hhd, Md^Xm, Xu, Xu
Dd, Dd, Dd, Dd, Dd, Dd, Dd, Dd, Dd, Hd, Hd, Hd, Hhd, Hhd, Hhd, Hh, Mm, Hhd, Hhd, Hhd, Hh, Mm, Hh, Mm, Hh, Mm, Hh, Mm, Hhd, Hh, Hhd, Hh, Hhd, Hh, Hhd, Mm, Hhd, Hhd, Hhd, Md^Xm, Xu, Xu
Dd, Dd, Dd, Dd, Dd, Dd, Dd, Dd, Dd, Hd, Hd, Hhd, Hd, Hhd, Hhd, Hhd, Hhd, Hhd, Hhd, Hhd, Hhd, Hhd, Hhd, Hh, Hh, Hh, Hhd, Hhd, Hhd, Hhd, Hhd, Hhd, Hhd, Hh, Hh, Hhd, Hhd, Mm, Md^Xm, Md^Xm, Xu, Xu
