Urb, Rp, Rp, Xos, Xos, Xos, Xos, Xos, Xos, Xos, Xos, Xos, Xos, Xos, Xos, Xos, Xos, Xos, Xos, Xos, Xos, Xos, Xos, Xos, Xos, Xos, Xos, Xos, Xos, Xos, Xos, Xos, Xos, Xos, Xos, Xos, Xos, Xos, Xos, Xos, Xos, Xos, Xos, Xos, Xos, Xos, Xos, Xos, Xos, Xos, Xos, Xos, Xos, Xos, Xos, Xos, Xos, Xos, Wwg, Wwg
Rp, Urb, Urb, Rp, Rp, Xos, Rp, Qxe, Urb, Xos, Xos, Xos, Xos, Xos, Xos, Xos, Xos, Xos, Xos, Xos, Xos, Xos, Xos, Xos, Xos, Xos, Xos, Xos, Xos, Xos, Xos, Xos, Xos, Xos, Xos, Xos, Xos, Xos, Xos, Xos, Xos, Xos, Xos, Xos, Xos, Xos, Xos, Xos, Xos, Xos, Xos, Xos, Xos, Xos, Xos, Xos, Xos, Xos, Wog, Wog
Xos, Rp, Rp, Urb, Urb, Rp, Urb, Urb, Qxe, Urb, Qxe, Xos, Xos, Xos, Xos, Xos, Xos, Xos, Xos, Xos, Xos, Xos, Xos, Xos, Xos, Xos, Xos, Xos, Xos, Xos, Xos, Xos, Xos, Xos, Xos, Xos, Xos, Xos, Xos, Xos, Xos, Xos, Xos, Xos, Xos, Xos, Xos, Xos, Xos, Xos, Xos, Xos, Xos, Xos, Xos, Xos, Wwg, Wwg, Wog, Wwg
Xos, Xos, Xos, Rp, Urb, Urb, Chr, Rp^Vhcr, Chr, Urb, Urb, Urb, Xos, Xos, Xos, Xos, Xos, Xos, Xos, Xos, Xos, Xos, Xos, Xos, Xos, Xos, Xos, Xos, Xos, Xos, Xos, Xos, Xos, Xos, Xos, Xos, Xos, Xos, Xos, Xos, Xos, Xos, Xos, Xos, Xos, Xos, Xos, Xos, Xos, Xos, Xos, Xos, Xos, Xos, Xos, Xos, Wwg, Wog, Xos, Xos
Xos, Xos, Xos, Qxe, Urb, Chr, Rr, Chr, Chr, Rp^Vhcr, Urb, Qxe, Xos, Xos, Xos, Xos, Xos, Xos, Xos, Xos, Xos, Xos, Xos, Xos, Xos, Xos, Xos, Xos, Xos, Xos, Xos, Xos, Xos, Xos, Xos, Xos, Xos, Xos, Xos, Xos, Xos, Xos, Xos, Xos, Xos, Xos, Xos, Xos, Xos, Xos, Xos, Xos, Xos, Xos, Wwg, Wog, Wog, Wwg, Xos, Xos
Xos, Xos, Xos, Qxe, Urb, Chr, Chr, 2 Khr, Rr, Chr, Qxe, Urb, Xos, Xos, Xos, Xos, Xos, Xos, Xos, Xos, Xos, Xos, Xos, Xos, Xos, Xos, Xos, Xos, Xos, Xos, Xos, Xos, Xos, Xos, Xos, Xos, Xos, Xos, Xos, Xos, Xos, Xos, Xos, Xos, Xos, Xos, Xos, Xos, Xos, Xos, Xos, Xos, Xos, Wwg, Wog, Wog, Xos, Xos, Xos, Xos
Xos, Xos, Xos, Urb, Qxe, Rp^Vhcr, Chr, Chr, Chr, Chr, Urb, Urb, Xos, Xos, Xos, Xos, Xos, Xos, Xos, Xos, Xos, Xos, Xos, Xos, Xos, Xos, Xos, Xos, Xos, Xos, Xos, Xos, Xos, Xos, Xos, Xos, Xos, Xos, Xos, Xos, Xos, Xos, Xos, Xos, Xos, Xos, Xos, Xos, Xos, Xos, Xos, Xos, Wog, Wog, Xos, Xos, Xos, Xos, Xos, Xos
Xos, Xos, Xos, Urb, Urb, Urb, Urb, Rp^Vhcr, Urb, Urb, Urb, Urb, Chr, Xos, Xos, Xos, Xos, Xos, Xos, Xos, Xos, Xos, Xos, Xos, Xos, Xos, Xos, Xos, Xos, Xos, Xos, Xos, Xos, Xos, Xos, Xos, Xos, Xos, Xos, Xos, Xos, Xos, Xos, Xos, Xos, Xos, Xos, Xos, Xos, Xos, Xos, Wwg, Wog, Wwg, Xos, Xos, Xos, Xos, Xos, Xos
Xos, Xos, Xos, Xos, Xos, Qxe, Urb, Qxe, Urb, Urb, Chr, Urb, Urb, Rr, Rr, Xos, Xos, Xos, Xos, Xos, Xos, Xos, Xos, Xos, Xos, Xos, Xos, Xos, Xos, Xos, Xos, Xos, Rr, Xos, Rr, Xos, Xos, Xos, Xos, Xos, Xos, Xos, Xos, Xos, Xos, Xos, Xos, Xos, Xos, Xos, Wwg, Wog, Wwg, Xos, Xos, Xos, Xos, Xos, Xos, Xos
Xos, Xos, Xos, Xos, Xos, Xos, Xos, Qxe, Xos, Xos, Xos, Rr, Rr, Urb, Urb, Rr, Rr, Xos, Xos, Xos, Xos, Xos, Xos, Xos, Xos, Xos, Xos, Xos, Xos, Xos, Rr^Dr, Rr, Urb, Chr^Dr, Urb, Rr, Rr, Xos, Xos, Xos, Xos, Xos, Xos, Xos, Xos, Xos, Xos, Xos, Xos, Xos, Wog, Wog, Xos, Xos, Xos, Xos, Xos, Xos, Xos, Xos
Xos, Xos, Xos, Xos, Xos, Xos, Xos, Xos, Xos, Xos, Xos, Xos, Xos, Rr, Rr, Urb, Urb, Rr, Rr, Xos, Xos, Xos, Xos, Xos, Xos, Xos, Xos, Xos, Rr, Rr, Urb, Urb, Rr, Urb, Rr, Urb^Dr, Urb, Rr, Rr, Xos, Xos, Xos, Xos, Xos, Xos, Xos, Xos, Xos, Xos, Wwg, Wog, Wog, Xos, Xos, Xos, Xos, Xos, Xos, Xos, Xos
Xos, Xos, Xos, Xos, Xos, Xos, Xos, Xos, Xos, Xos, Xos, Xos, Xos, Xos, Xos, Rr, Rr, Urb, Urb, Rr, Rr, Rr, Rr, Chr, Rr, Rr, Rr, Rr, Urb, Urb, Rr, Rr^Dr, Xos, Chr, Xos, Rr, Rr, Urb, Urb, Rr, Rr, Xos, Xos, Xos, Xos, Xos, Xos, Xos, Xos, Xos, Wog, Wwg, Xos, Xos, Xos, Xos, Xos, Xos, Xos, Xos
Xos, Xos, Xos, Xos, Xos, Xos, Xos, Xos, Xos, Xos, Xos, Xos, Xos, Xos, Xos, Xos, Xos, Rr, Rr, Urb, Urb, Urb, Urb, Urb, Urb, Urb, Urb, Urb, Rr, Rr, Xos, Xos, Xos, Xos, Xos, Xos, Xos, Rr^Dr, Rr, Urb, Rr, Xos, Xos, Xos, Xos, Xos, Xos, Xos, Xos, Wog, Wwg, Wwg, Xos, Xos, Xos, Xos, Xos, Xos, Xos, Xos
Xos, Xos, Xos, Xos, Xos, Xos, Xos, Xos, Xos, Xos, Xos, Xos, Xos, Xos, Xos, Xos, Xos, Xos, Xos, Rr, Rr, Rr, Rr, Chr, Rr, Rr, Rr, Rr, Xos, Xos, Xos, Xos, Xos, Xos, Xos, Xos, Xos, Rr, Urb^Dr, Urb, Rr, Xos, Xos, Xos, Xos, Xos, Xos, Xos, Wog, Wwg, Wwg, Xos, Xos, Xos, Xos, Xos, Xos, Xos, Xos, Xos
Xos, Xos, Xos, Xos, Xos, Xos, Xos, Xos, Xos, Xos, Xos, Xos, Xos, Xos, Xos, Xos, Xos, Xos, Xos, Xos, Xos, Xos, Xos, Xos, Xos, Xos, Xos, Xos, Xos, Xos, Xos, Xos, Xos, Xos, Xos, Xos, Rr, Rr, Urb, Rr^Dr, Xos, Xos, Xos, Xos, Xos, Xos, Xos, Wog, Wog, Wwg, Xos, Xos, Xos, Xos, Xos, Xos, Xos, Xos, Xos, Xos
Xos, Xos, Xos, Xos, Xos, Xos, Xos, Xos, Xos, Xos, Xos, Xos, Xos, Xos, Xos, Xos, Xos, Xos, Xos, Xos, Xos, Xos, Xos, Xos, Xos, Xos, Xos, Xos, Xos, Xos, Xos, Xos, Xos, Xos, Rr, Rr, Urb, Urb, Rr, Rr, Xos, Xos, Xos, Xos, Wwg, Xos, Wwg, Wog, Wwg, Xos, Xos, Xos, Xos, Xos, Xos, Xos, Xos, Xos, Xos, Xos
Xos, Xos, Xos, Xos, Xos, Xos, Xos, Xos, Xos, Xos, Xos, Xos, Xos, Xos, Xos, Xos, Xos, Xos, Xos, Xos, Xos, Xos, Xos, Xos, Xos, Xos, Xos, Xos, Xos, Xos, Xos, Xos, Rr, Rr, Urb, Urb^Dr, Rr, Rr^Dr, Xos, Xos, Xos, Xos, Xos, Xos, Wwg, Wwg, Wog, Wog, Xos, Xos, Xos, Xos, Xos, Xos, Xos, Xos, Xos, Xos, Xos, Xos
Xos, Xos, Xos, Xos, Xos, Xos, Xos, Xos, Xos, Xos, Xos, Xos, Xos, Xos, Xos, Xos, Xos, Xos, Xos, Xos, Xos, Xos, Xos, Xos, Xos, Xos, Xos, Xos, Xos, Xos, Xos, Rr, Urb, Urb^Dr, Rr, Rr, Xos, Xos, Xos, Xos, Xos, Xos, Xos, Xos, Wwg, Wog, Wog, Wog, Xos, Xos, Xos, Xos, Xos, Xos, Xos, Xos, Xos, Xos, Xos, Xos
Xos, Xos, Xos, Xos, Xos, Xos, Xos, Xos, Xos, Xos, Xos, Xos, Xos, Xos, Xos, Xos, Xos, Xos, Xos, Xos, Xos, Xos, Xos, Xos, Xos, Xos, Xos, Xos, Xos, Xos, Xos, Chr, Urb, Chr, Xos, Xos, Xos, Xos, Xos, Xos, Xos, Xos, Xos, Xos, Wwg, Wog, Wog, Wwg, Wwf, Rb^Edt, Xos, Xos, Xos, Xos, Qxua, Qxua, Qxua, Xos, Xos, Xos
Xos, Xos, Xos, Xos, Xos, Xos, Xos, Xos, Xos, Xos, Xos, Xos, Xos, Xos, Xos, Xos, Xos, Xos, Xos, Xos, Xos, Xos, Xos, Xos, Xos, Xos, Xos, Xos, Xos, Xos, Xos, Rr, Urb, Rr, Xos, Xos, Xos, Xos, Xos, Xos, Xos, Xos, Xos, Xos, Wwg, Wog, Wog, Wwg, Wwg, Wwf, Xos, Xos, Qxua, Qxua, Urb^Edb, Urb, Urb^Edb, Qxua, Qxua, Xos
Xos, Xos, Xos, Xos, Xos, Xos, Xos, Xos, Xos, Xos, Xos, Xos, Xos, Xos, Xos, Xos, Xos, Xos, Xos, Xos, Xos, Xos, Xos, Xos, Xos, Xos, Xos, Xos, Xos, Xos, Xos, Rr, Urb, Rr^Dr, Rr, Xos, Xos, Xos, Xos, Xos, Xos, Xos, Xos, Xos, Wwf, Wog, Wwg, Wwg, Wwf, Wwf, Xos, Xos, Qxua, Urb, Urb, Rp, Urb, Qxua, Urb^Edt, Xos
Xos, Xos, Xos, Xos, Xos, Xos, Xos, Xos, Xos, Xos, Xos, Xos, Xos, Xos, Xos, Xos, Xos, Xos, Xos, Xos, Xos, Xos, Xos, Xos, Xos, Xos, Xos, Xos, Xos, Xos, Rr, Rr^Dr, Rr, Urb, Rr, Xos, Xos, Xos, Xos, Xos, Xos, Xos, Xos, Xos, Wwg, Wwg, Wwg, Wwf, Xos, Xos, Xos, Qxua, Urb^Edt, Urb, Rp^Edt, Rp, Urb, Urb, Qxua, Xos
Xos, Xos, Xos, Xos, Xos, Xos, Xos, Xos, Xos, Xos, Xos, Xos, Xos, Xos, Xos, Xos, Xos, Xos, Xos, Xos, Xos, Xos, Xos, Xos, Xos, Xos, Xos, Xos, Rr, Rr, Urb, Urb, Urb, Urb^Dr, Rr, Xos, Xos, Xos, Xos, Xos, Xos, Xos, Xos, Ss^Vhs, Wwf, Sm, Xos, Xos, Xos, Xos, Xos, Xos, Xos, Rp, Urb, Urb, Qxua, Urb^Edt, Xos, Xos
Xos, Xos, Xos, Xos, Xos, Xos, Xos, Xos, Xos, Xos, Xos, Xos, Xos, Xos, Xos, Xos, Xos, Xos, Xos, Xos, Xos, Xos, Xos, Xos, Xos, Xos, Rr^Dr, Rr, Urb^Dr, Urb, Urb, Rr^Dr, Rr, Rr, Xos, Xos, Xos, Xos, Xos, Xos, Xos, Xos, Xos, Ss, Chs, Ss, Xos, Xos, Xos, Xos, Rp, Rr, Qxe, Xos, Xos, Urb^Edb, Xos, Xos, Xos, Xos
Xos, Xos, Xos, Xos, Xos, Xos, Xos, Xos, Xos, Xos, Xos, Xos, Xos, Xos, Xos, Xos, Xos, Xos, Xos, Xos, Xos, Xos, Xos, Xos, Xos, Xos, Qxe, Qxe, Urb, Rr, Rr^Dr, Rr, Xos, Xos, Rr, Rp, Rr, Xos, Xos, Xos, Xos, Xos, Xos, Xos, Wwg, Ss, Chw, Xos, Wwg, Wwg, Wwf, Rp, Rr, Rp, Qxe, Xos, Xos, Xos, Xos, Xos
Xos, Xos, Xos, Xos, Xos, Xos, Xos, Xos, Xos, Xos, Xos, Xos, Xos, Xos, Xos, Xos, Xos, Xos, Xos, Xos, Xos, Xos, Xos, Xos, Xos, Qxe, Urb, Urb, Qxe, Qxe, Xos, Xos, Rr, Rp, Urb, Urb, Urb, Rp, Rr, Xos, Xos, Xos, Xos, Chw, Wwg, Wwg, Wwf, Chw, Wwg, Wwg, Wwg, Urb, Urb, Rr, Rp, Qxe, Xos, Xos, Xos, Xos
Xos, Xos, Xos, Xos, Xos, Xos, Xos, Xos, Xos, Xos, Xos, Xos, Xos, Xos, Xos, Xos, Xos, Xos, Xos, Xos, Xos, Xos, Xos, Xos, Xos, Rr^Dr, Urb, Khr, Rr^Dr, Qxe, Rr, Rr, Urb^Dr, Urb, Rr, Rp, Rp, Urb, Rr^Dr, Xos, Rp, Xos, Chw, Ss^Vhs, Wwf, Khw, Wwg, Wwf, Chw, Wwg, Xos, Rr, Rr, Urb, Rr, Qxe, Xos, Xos, Xos, Xos
Xos, Xos, Xos, Xos, Xos, Xos, Xos, Xos, Xos, Xos, Xos, Xos, Xos, Xos, Xos, Xos, Xos, Xos, Xos, Xos, Xos, Xos, Xos, Xos, Xos, Qxe, Qxe, Urb, Urb, Urb^Dr, Urb, Urb, Rr, Rr, Xos, Xos, Rp, Urb, Urb, Rp, Urb, Rp, Urb, Urb, Chw, Wwg, Wwg, Ss^Vhs, Xos, Xos, Xos, Xos, Rp, Urb, Rp, Qxe, Qxe, Xos, Xos, Xos
Xos, Xos, Xos, Xos, Xos, Xos, Xos, Xos, Xos, Xos, Xos, Xos, Xos, Xos, Xos, Xos, Xos, Xos, Xos, Xos, Xos, Xos, Xos, Xos, Qxe, Qxe, Qxe, Rr^Dr, Qxe, Rr, Rr^Dr, Rr, Qxe, Xos, Xos, Xos, Xos, Rr^Dr, Rr, Urb, Rp, Urb, Rr, Chw, Wwg, Ss, Chw, Chw, Xos, Xos, Xos, Rr, Urb, Urb, Rr, Qxe, Qxe, Xos, Xos, Xos
Xos, Xos, Xos, Xos, Xos, Xos, Xos, Xos, Xos, Xos, Xos, Xos, Xos, Xos, Xos, Xos, Xos, Xos, Xos, Xos, Xos, Xos, Xos, Xos, Qxe, Uu, Uu, Qxe, Uu, Qxe, Qxe, Qxe, Qxe, Xos, Xos, Xos, Xos, Xos, Xos, Rp, Xos, Rp, Xos, Xos, Wog, Wwg, Wog, Xos, Xos, Xos, Qxe, Rp, Urb, Rp, Qxe, Qxe, Xos, Xos, Xos, Xos
Xos, Xos, Xos, Xos, Xos, Xos, Xos, Xos, Xos, Xos, Xos, Xos, Xos, Xos, Xos, Xos, Xos, Xos, Xos, Xos, Xos, Xos, Xos, Xos, Xos, Qxe, Qxe, Qxe, Qxe, Qxe, Uh, Xos, Xos, Qxe, Xos, Xos, Xos, Xos, Xos, Xos, Xos, Xos, Xos, Ss, Ss, Wwg, Wog, Ss, Ss, Qxe, Rp, Rp, Urb, Rr, Qxe, Qxe, Xos, Xos, Xos, Xos
Xos, Xos, Xos, Xos, Xos, Xos, Xos, Xos, Xos, Xos, Xos, Xos, Xos, Xos, Xos, Xos, Xos, Xos, Xos, Xos, Xos, Xos, Xos, Xos, Xos, Xos, Xos, Uh, Qxe, Uu^Tf, Xos, Xos, Qxe, Qxe, Xos, Xos, Xos, Xos, Xos, Xos, Xos, Xos, Xos, Ss, Xos, Wwg, Wwg, Qxe, Qxe, Qxe, Rp, Urb, Rr, Rr, Xos, Xos, Xos, Xos, Xos, Xos
Xos, Xos, Xos, Xos, Xos, Xos, Xos, Xos, Xos, Xos, Xos, Xos, Xos, Xos, Xos, Xos, Xos, Xos, Xos, Xos, Xos, Xos, Xos, Xos, Xos, Xos, Xos, Xos, Xos, Qxe, Qxe, Qxe, Xos, Xos, Xos, Xos, Xos, Xos, Xos, Xos, Xos, Xos, Xos, Xos, Rp, Sm, Wwg, Wwg, Wwf, Rp, Urb, Urb, Rp, Qxe, Xos, Xos, Xos, Xos, Xos, Xos
Xos, Xos, Xos, Xos, Xos, Xos, Xos, Xos, Xos, Xos, Xos, Xos, Xos, Xos, Xos, Xos, Xos, Xos, Xos, Xos, Xos, Xos, Xos, Xos, Xos, Xos, Xos, Xos, Xos, Xos, Xos, Xos, Xos, Xos, Xos, Xos, Xos, Xos, Xos, Xos, Rp^Dr, Xos, Rp, Rp, Urb, Wwf, Wwf, Chw, Wwg, Urb, Urb, Urb, Rr, Xos, Xos, Xos, Xos, Xos, Xos, Xos
Xos, Xos, Xos, Xos, Xos, Xos, Xos, Xos, Xos, Xos, Xos, Xos, Xos, Xos, Xos, Xos, Xos, Xos, Xos, Xos, Xos, Xos, Xos, Xos, Xos, Xos, Xos, Xos, Xos, Xos, Xos, Xos, Xos, Xos, Xos, Xos, Xos, Xos, Rp, Rp, Urb^Dr, Rp, Urb, Urb, Rp, Rp, Wwf, Wwg, Wwg, Wwg, Rp, Rp, Wwg, Wwg, Xos, Xos, Xos, Xos, Xos, Xos
Xos, Xos, Xos, Xos, Xos, Xos, Xos, Xos, Xos, Xos, Xos, Xos, Xos, Xos, Xos, Xos, Xos, Xos, Xos, Xos, Xos, Xos, Xos, Xos, Xos, Xos, Xos, Xos, Xos, Xos, Xos, Xos, Xos, Xos, Xos, Xos, Rp, Rp^Dr, Urb, Urb, Rp, Urb^Dr, Urb, Rp, Rp^Dr, Xos, Xos, Sm, Xos, Wwg, Wwg, Xos, Xos, Ss, Ss, Xos, Xos, Xos, Xos, Xos
Xos, Xos, Xos, Xos, Xos, Xos, Xos, Xos, Xos, Xos, Xos, Xos, Xos, Xos, Xos, Xos, Xos, Xos, Xos, Xos, Xos, Xos, Xos, Xos, Xos, Xos, Xos, Xos, Xos, Xos, Xos, Xos, Xos, Xos, Rp, Rp, Urb^Dr, Urb, Rp, Rp^Dr, Xos, Rp, Rp, Urb, Urb, Rp, Rp, Xos, Qxe, Xos, Wwg, Wwg, Wwg, Ss, Sm, Xos, Xos, Xos, Xos, Xos
Xos, Xos, Xos, Xos, Xos, Xos, Xos, Xos, Xos, Xos, Xos, Xos, Xos, Xos, Xos, Xos, Xos, Xos, Xos, Xos, Xos, Xos, Xos, Xos, Xos, Xos, Xos, Xos, Xos, Xos, Xos, Xos, Rp^Dr, Rp, Urb, Urb, Rp, Rp, Xos, Xos, Xos, Xos, Xos, Rp, Rp, Urb, Rp, Xos, Rp, Qxe, Rb, Xos, Wwg, Wwg, Wwg, Xos, Xos, Xos, Xos, Xos
Xos, Xos, Xos, Xos, Xos, Xos, Xos, Xos, Xos, Xos, Xos, Xos, Xos, Xos, Xos, Xos, Xos, Xos, Xos, Xos, Xos, Xos, Xos, Xos, Xos, Xos, Xos, Xos, Xos, Xos, Xos, Xos, Rp, Urb^Dr, Rp, Rp, Xos, Xos, Xos, Xos, Xos, Xos, Xos, Xos, Rp, Urb^Dr, Urb, Rp, Xos, Rp, Qxe, Wwf, Xos, Wog, Wog, Wog, Wog, Xos, Xos, Xos
Xos, Xos, Xos, Xos, Xos, Xos, Xos, Xos, Xos, Xos, Xos, Xos, Xos, Xos, Xos, Xos, Xos, Xos, Xos, Xos, Xos, Xos, Xos, Xos, Xos, Xos, Xos, Xos, Xos, Xos, Xos, Xos, Rp, Urb, Rp^Dr, Xos, Xos, Qxe, Xos, Xos, Xos, Xos, Xos, Xos, Xos, Rp, Urb, Rp, Xos, Qxe, Qxe, Xos, Xos, Xos, Wwg, Wwg, Wog, Wwg, Wwg, Xos
Xos, Xos, Xos, Xos, Xos, Xos, Xos, Xos, Xos, Xos, Xos, Xos, Xos, Xos, Xos, Xos, Xos, Xos, Xos, Xos, Xos, Xos, Xos, Xos, Xos, Xos, Xos, Xos, Xos, Xos, Xos, Xos, Rp, Urb, Rp, Xos, Xos, Qxe, Qxe, Qxe, Qxe, Xos, Xos, Xos, Xos, Rp, Urb, Rp, Qxe, Qxe, Qxe, Qxe, Xos, Xos, Xos, Wog, Wwg, Wog, Wog, Xos
Xos, Xos, Xos, Xos, Xos, Xos, Xos, Xos, Xos, Xos, Xos, Xos, Xos, Xos, Xos, Xos, Xos, Xos, Xos, Xos, Xos, Xos, Xos, Xos, Xos, Xos, Xos, Xos, Xos, Xos, Xos, Xos, Rp^Dr, Urb, Rp, Xos, Xos, Xos, Xos, Xos, Qxe, Xos, Xos, Xos, Rp, Rp^Dr, Urb, Rp, Rp, Qxe, Qxe, Xos, Xos, Xos, Xos, Wog, Wwg, Wog, Wog, Wog
Xos, Xos, Xos, Xos, Xos, Xos, Xos, Xos, Xos, Xos, Xos, Xos, Xos, Xos, Xos, Xos, Xos, Xos, Xos, Xos, Xos, Xos, Xos, Xos, Xos, Xos, Xos, Xos, Xos, Xos, Xos, Xos, Rp, Urb, Urb, Rp^Dr, Rp^Dr, Xos, Xos, Xos, Qxe, Qxe, Rp, Rp, Rb, Urb, Rp, Urb, Urb, Rb, Re, Xos, Xos, Xos, Xos, Wog, Wwg, Xos, Xos, Wog
Xos, Xos, Xos, Xos, Xos, Xos, Xos, Xos, Xos, Xos, Xos, Xos, Xos, Xos, Xos, Xos, Xos, Xos, Xos, Xos, Xos, Xos, Xos, Xos, Xos, Xos, Xos, Xos, Xos, Xos, Xos, Xos, Xos, Rp, Rp, Urb, Urb, Rp, Rp, Xos, Rr, Qxe, Urb, Urb, Re, Rp, Xos, Rr, Rb, Re, Rb, Xos, Xos, Xos, Xos, Wwg, Wwg, Xos, Xos, Xos
Xos, Xos, Xos, Xos, Xos, Xos, Xos, Xos, Xos, Xos, Xos, Xos, Xos, Xos, Xos, Xos, Xos, Xos, Xos, Xos, Xos, Xos, Xos, Xos, Xos, Xos, Xos, Xos, Xos, Xos, Xos, Xos, Xos, Xos, Xos, Rp^Dr, Rp, Urb, Urb, Rb, Urb, Urb^Dr, Rb, Rb, Xos, Xos, Xos, Xos, Rr, Urb, Rr, Xos, Xos, Xos, Wwg, Wwg, Wwg, Xos, Xos, Xos
Xos, Xos, Xos, Xos, Xos, Xos, Xos, Xos, Xos, Xos, Xos, Xos, Xos, Xos, Xos, Xos, Xos, Xos, Xos, Xos, Xos, Xos, Xos, Xos, Xos, Xos, Xos, Xos, Xos, Xos, Xos, Xos, Xos, Xos, Xos, Xos, Rr, Rr, Urb^Dr, Urb, Rr^Dr, Rr, Xos, Xos, Xos, Xos, Xos, Xos, Rb, Urb, Rb, Xos, Xos, Xos, Wwg, Wog, Xos, Xos, Xos, Xos
Xos, Xos, Xos, Xos, Xos, Xos, Xos, Xos, Xos, Xos, Xos, Xos, Xos, Xos, Xos, Xos, Xos, Xos, Xos, Xos, Xos, Xos, Xos, Xos, Xos, Xos, Xos, Xos, Xos, Xos, Xos, Xos, Xos, Xos, Rb, Qxe, Urb, Urb, Re, Rr, Xos, Xos, Xos, Xos, Xos, Xos, Xos, Xos, Rr, Urb, Rb, Xos, Wwg, Wog, Wwg, Xos, Xos, Xos, Xos, Xos
Xos, Xos, Xos, Xos, Xos, Xos, Xos, Xos, Xos, Xos, Xos, Xos, Xos, Xos, Xos, Xos, Xos, Xos, Xos, Xos, Xos, Xos, Xos, Xos, Xos, Xos, Xos, Xos, Xos, Xos, Xos, Xos, Rb, Rr, Urb, Re, Rr^Dr, Rb, Xos, Xos, Xos, Xos, Xos, Xos, Xos, Xos, Re, Re, Wwf, Urb, Wwg, Wwg, Wog, Wog, Xos, Xos, Xos, Xos, Xos, Xos
Xos, Xos, Xos, Xos, Xos, Xos, Xos, Xos, Xos, Xos, Xos, Xos, Xos, Xos, Xos, Xos, Xos, Xos, Xos, Xos, Xos, Xos, Xos, Xos, Xos, Xos, Xos, Xos, Xos, Xos, Rr, Rr, Urb, Urb, Qxe, Qxe, Rr, Xos, Xos, Xos, Xos, Xos, Xos, Xos, Wwg, Wwg, Wog, Wwg, Rr, Wwg, Wog, Wog, Xos, Xos, Xos, Xos, Xos, Xos, Xos, Xos
Xos, Xos, Xos, Xos, Xos, Xos, Xos, Xos, Xos, Xos, Xos, Xos, Xos, Xos, Xos, Xos, Xos, Xos, Xos, Xos, Xos, Xos, Xos, Xos, Xos, Xos, Xos, Xos, Rr, Re, Rb, Urb^Dr, Rb, Rr, Rb^Dr, Re, Xos, Xos, Xos, Xos, Xos, Xos, Rr, Rr, Wwf, Wwg, Wwg, Wwf, Wwg, Wog, Xos, Xos, Xos, Xos, Xos, Xos, Xos, Xos, Xos, Xos
Xos, Xos, Xos, Xos, Xos, Xos, Xos, Xos, Xos, Xos, Xos, Xos, Xos, Xos, Xos, Xos, Xos, Xos, Xos, Xos, Xos, Xos, Xos, Xos, Xos, Xos, Rb, Rr, Urb, Urb, Rr^Dr, Qxe, Xos, Xos, Xos, Xos, Xos, Xos, Xos, Xos, Rb, Rr, Urb^Dr, Urb, Wwg, Wwf, Xos, Qxe, Xos, Wog, Xos, Xos, Xos, Xos, Xos, Xos, Xos, Xos, Xos, Xos
Xos, Xos, Xos, Xos, Xos, Xos, Xos, Xos, Xos, Xos, Xos, Xos, Xos, Xos, Xos, Xos, Xos, Xos, Xos, Xos, Xos, Xos, Xos, Xos, Xos, Rr, Urb, Urb^Dr, Rr, Rr, Xos, Xos, Xos, Xos, Xos, Xos, Xos, Xos, Re, Rr^Dr, Urb, Urb, Rr, Re, Qxe, Xos, Xos, Xos, Xos, Xos, Xos, Xos, Xos, Xos, Xos, Xos, Xos, Xos, Xos, Xos
Xos, Xos, Xos, Xos, Xos, Xos, Xos, Xos, Xos, Xos, Xos, Xos, Xos, Xos, Xos, Xos, Xos, Xos, Xos, Xos, Xos, Xos, Xos, Xos, Xos, Rr^Dr, Urb, Rb, Xos, Xos, Xos, Xos, Xos, Xos, Xos, Xos, Rr, Rr^Dr, Urb, Urb, Rr^Dr, Rb, Wwf, Wwg, Qxe, Xos, Xos, Xos, Xos, Xos, Xos, Xos, Xos, Xos, Xos, Xos, Xos, Xos, Xos, Xos
Xos, Xos, Xos, Xos, Xos, Xos, Xos, Xos, Xos, Xos, Xos, Xos, Xos, Xos, Xos, Xos, Xos, Xos, Xos, Xos, Xos, Xos, Xos, Xos, Xos, Rr, Xos, Rr, Xos, Xos, Xos, Xos, Xos, Xos, Wwg, Rb, Wwg, Wwf, Wwg, Re, Wwg, Wwg, Xos, Wwg, Xos, Xos, Xos, Xos, Xos, Xos, Xos, Xos, Xos, Xos, Xos, Xos, Xos, Xos, Xos, Xos
Xos, Xos, Xos, Xos, Xos, Xos, Xos, Xos, Xos, Xos, Xos, Xos, Xos, Xos, Xos, Xos, Xos, Xos, Xos, Xos, Xos, Xos, Xos, Xos, Xos, Xos, Urb, Xos, Xos, Xos, Xos, Xos, Rr, Wwg, Urb, Wwg, Re, Wwf, Qxe, Wwg, Xos, Xos, Xos, Xos, Xos, Xos, Xos, Xos, Xos, Xos, Xos, Xos, Xos, Xos, Xos, Xos, Xos, Xos, Xos, Xos
Xos, Xos, Xos, Xos, Xos, Xos, Xos, Xos, Xos, Xos, Xos, Xos, Xos, Xos, Xos, Xos, Rr, Xos, Xos, Xos, Xos, Xos, Xos, Xos, Rr^Dr, Rr, Urb, Urb, Urb, Xos, Rb, Rr^Dr, Wwg, Wwg, Rr, Rr, Xos, Xos, Qxe, Wwg, Xos, Xos, Xos, Xos, Xos, Xos, Xos, Xos, Xos, Xos, Xos, Xos, Xos, Xos, Xos, Xos, Xos, Xos, Xos, Xos
Xos, Xos, Xos, Xos, Xos, Xos, Xos, Xos, Xos, Xos, Xos, Xos, Xos, Xos, Rr, Rr, Wwg, Rr, Rr, Xos, Xos, Xos, Rr, Rr, Urb, Urb, Rr, Rr, Xos, Xos, Wwf, Wwg, Re, Rr^Dr, Sm, Qxe, Xos, Xos, Wwg, Wwg, Xos, Xos, Xos, Xos, Xos, Xos, Xos, Xos, Xos, Xos, Xos, Xos, Xos, Xos, Xos, Xos, Xos, Xos, Xos, Xos
Xos, Xos, Xos, Xos, Xos, Xos, Xos, Xos, Xos, Xos, Xos, Xos, Xos, Rr, Rr, Wwg, Rr, Rr, Xos, Xos, Rr, Rr^Dr, Urb, Urb, Rr, Rr, Xos, Xos, Xos, Xos, Wwf, Rb, Wwg, Wwf, Wwf, Sm, Wwf, Wwg, Xos, Xos, Xos, Xos, Xos, Xos, Xos, Xos, Xos, Xos, Xos, Xos, Xos, Xos, Xos, Xos, Xos, Xos, Xos, Xos, Xos, Xos
Xos, Xos, Xos, Xos, Xos, Xos, Xos, Xos, Xos, Xos, Rr, Rr, Rr, Xos, Xos, Rr, Rr^Xo, Rr^Xo, Urb, Rr, Urb, Urb, Rr^Dr, Rr, Xos, Xos, Xos, Xos, Xos, Xos, Wwg, Wog, Wwf, Sm, Wwf, Sm, Xos, Xos, Xos, Xos, Xos, Xos, Xos, Xos, Xos, Xos, Xos, Xos, Xos, Xos, Xos, Xos, Xos, Xos, Xos, Xos, Xos, Xos, Xos, Xos
Xos, Xos, Xos, Xos, Xos, Xos, Xos, Xos, Rr, Rr, Wwg, Wwg, Rr, Rr, Xos, Xos, Urb, Urb, Urb, Urb, Urb, Rr, Xos, Xos, Xos, Xos, Xos, Xos, Xos, Xos, Xos, Wwg, Wog, Wwg, Qxe, Xos, Xos, Xos, Xos, Xos, Xos, Xos, Xos, Xos, Xos, Xos, Xos, Xos, Xos, Xos, Xos, Xos, Xos, Xos, Xos, Xos, Xos, Xos, Xos, Xos
Xos, Xos, Xos, Xos, Xos, Xos, Xos, Xos, Xos, Rr, Rr, Rr, Rr^Xo, Xos, Rr, Rr, Urb, Urb^Dr, Rr, Urb, Rr^Xo, Rr^Xo, Rr, Xos, Xos, Xos, Xos, Xos, Xos, Xos, Xos, Qxe, Wwg, Wwg, Wwg, Xos, Xos, Xos, Xos, Xos, Xos, Xos, Xos, Xos, Xos, Xos, Xos, Xos, Xos, Xos, Xos, Xos, Xos, Xos, Xos, Xos, Xos, Xos, Xos, Xos
Xos, Xos, Xos, Xos, Xos, Xos, Xos, Xos, Xos, Xos, Xos, Rr^Xo, Urb, Urb, Urb, Urb, Urb, Rr, Xos, Xos, Rr, Rr, Wwg, Rr, Rr, Xos, Xos, Xos, Xos, Xos, Xos, Xos, Xos, Wwg, Wog, Wwg, Xos, Xos, Xos, Xos, Xos, Xos, Xos, Xos, Xos, Xos, Xos, Xos, Xos, Xos, Xos, Xos, Xos, Xos, Xos, Xos, Xos, Xos, Xos, Xos
Xos, Xos, Xos, Xos, Xos, Xos, Xos, Xos, Iwr, Xos, Xos, Xos, Xos, Urb, Urb^Dr, Urb, Rr^Xo, Xos, Xos, Rr, Rr, Wwg, Rr, Rr, Xos, Xos, Xos, Xos, Xos, Xos, Xos, Xos, Xos, Wwg, Wwg, Wog, Xos, Xos, Xos, Xos, Xos, Xos, Xos, Xos, Xos, Xos, Xos, Xos, Xos, Xos, Xos, Xos, Xos, Xos, Xos, Xos, Xos, Xos, Xos, Xos
Xos, Xos, Xos, Xos, Xos, Xos, Iwr, Iwr, Iwr, Iwr, Iwr, Xos, Xos, Xos, Xos, Rr^Xo, Rr, Rr, Rr, Xos, Xos, Rr, Xos, Xos, Xos, Xos, Xos, Xos, Xos, Xos, Xos, Xos, Xos, Wwg, Wog, Wog, Wog, Xos, Xos, Xos, Xos, Xos, Xos, Xos, Xos, Xos, Xos, Xos, Xos, Xos, Xos, Xos, Xos, Xos, Xos, Xos, Xos, Xos, Xos, Xos
Xos, Xos, Xos, Xos, Iwr, Iwr, Iwr^Cov, Iwr^Cov, Iwr^Cov, Iwr, Iwr, Iwr, Iwr, Xos, Rr, Rr, Wwg, Wwg, Rr, Rr, Xos, Xos, Xos, Xos, Xos, Xos, Xos, Xos, Xos, Xos, Xos, Xos, Xos, Xos, Wwg, Wog, Wwg, Wog, Wog, Xos, Xos, Xos, Xos, Xos, Xos, Xos, Xos, Xos, Xos, Xos, Xos, Xos, Xos, Xos, Xos, Xos, Xos, Xos, Xos, Xos
Xos, Xos, Xos, Iwr, Iwr, Iwr, Iwr^Cov, 1 Iwr^Kov, Iwr^Cov, Iwr, Iwr, Iwr, Xos, Xos, Xos, Rr, Rr, Rr, Xos, Xos, Xos, Xos, Xos, Xos, Xos, Xos, Xos, Xos, Xos, Xos, Xos, Xos, Xos, Xos, Wog, Wwg, Wwg, Wog, Wog, Xos, Xos, Xos, Xos, Xos, Xos, Xos, Xos, Xos, Xos, Xos, Xos, Xos, Xos, Xos, Xos, Xos, Xos, Xos, Xos, Xos
Xos, Xos, Xos, Xos, Xos, Iwr, Iwr, Iwr^Cov, Iwr, Iwr, Xos, Xos, Xos, Xos, Xos, Xos, Xos, Xos, Xos, Xos, Xos, Xos, Xos, Xos, Xos, Xos, Xos, Xos, Xos, Xos, Xos, Xos, Xos, Xos, Xos, Wog, Xos, Wwg, Wog, Wog, Xos, Xos, Xos, Xos, Xos, Xos, Xos, Xos, Xos, Xos, Xos, Xos, Xos, Xos, Xos, Xos, Xos, Xos, Xos, Xos
Xos, Xos, Xos, Xos, Xos, Xos, Xos, Iwr, Xos, Xos, Xos, Xos, Xos, Xos, Xos, Xos, Xos, Xos, Xos, Xos, Xos, Xos, Xos, Xos, Xos, Xos, Xos, Xos, Xos, Xos, Xos, Xos, Xos, Xos, Xos, Xos, Xos, Xos, Wog, Wog, Xos, Xos, Xos, Xos, Xos, Xos, Xos, Xos, Xos, Xos, Xos, Xos, Xos, Xos, Xos, Xos, Xos, Xos, Xos, Xos
Xos, Xos, Xos, Xos, Xos, Xos, Xos, Xos, Xos, Xos, Xos, Xos, Xos, Xos, Xos, Xos, Xos, Xos, Xos, Xos, Xos, Xos, Xos, Xos, Xos, Xos, Xos, Xos, Xos, Xos, Xos, Xos, Xos, Xos, Xos, Xos, Xos, Wwg, Wwg, Wwg, Xos, Xos, Xos, Xos, Xos, Xos, Xos, Xos, Xos, Xos, Xos, Xos, Xos, Xos, Xos, Xos, Xos, Xos, Xos, Xos
