Xos, Xos, Xos, Xos, Xos, Xos, Xos, Xos, Xos, Xos, Xos, Xos, Ur, Ur, Ur, Xos, Xos, Xos, Xos, Xos, Xos, Xos, Xos, Xos, Xos, Xos
Xos, Xos, Xos, Xos, Xos, Xos, Xos, Xos, Xos, Xos, Xos, Xos, Ur, Ur, Ur, Xos, Xos, Xos, Xos, Xos, Xos, Xos, Xos, Xos, Xos, Xos
Xos, Xos, Uue, Uue, Uu, Uue, Uu^Dr, Uu, Uue, Uue, Uue, Uu, Uu, Uu, Uu, Uue, Uh, Uu, Uue, Uu, Uu, Uue, Uue, Xos, Xos, Xos
Xos, Xos, Uu, Uu^Tf, Uh, Uue, Uue, Uu, Uu^Tf, Uu, Uu^Dr, Uu^Tf, Uu^Tf, Uu, Uue, Uu^Dr, Qxe, Uu, Uh, Uu^Tf, Uu, Qxe, Uu^Dr, Uu, Xos, Xos
Xos, Xos, Uu^Dr, Uu, Qxe, Qxe, Uh, Uh, Uu^Tf, Uu, Qxe, Uh, Uu^Dr, Uue, Uu^Tf, Qxe, Uu^Dr, Uue, Uu^Dr, Uue, Uh, Qxe, Uh, Uu^Tf, Xos, Xos
Xos, Xos, Uue, Uh, Uu^Dr, Uu, Uu, Uu^Dr, Uue, Qxe, Re, Uue, Rd, Uue, Uu, Uu, Uu, Uu, Rd, Uu, Uue, Uu^Tf, Uu^Dr, Uue, Xos, Xos
Xos, Xos, Uu, Uh, Uue, Uue, Uu, Uu^Tf, Rd^Edb, Rd, Chr, Re, Chr, Re, Chr, Rd, Chr^Dr, Re, Iwr^Dr, Re, Rd, Uue, Qxe, Rd, Xos, Xos
Xos, Xos, Rd, Uu^Tf, Uue, Qxe, Rd, Re, Iwr, Chr, Iwr, Rb^Dr, Iwr, Chr, Iwr^Edb, Rb^Dr, Iwr, Chr, Iwr, Iwr, Rb, Re, Wwg, Sm, Xos, Xos
Xos, Xos, Ss, Re, Rb, Re, Iwr, Iwr^Dr, Iwr, Chr, Chr^Dr, Khr, Iwr, Iwr, Iwr, Khr, Chr, Chr, Iwr, Iwr, Qxe, Sm, Wwg^Edb, Wwf, Xos, Xos
Xos, Xos, Ss^Edt, Sm, Sm, Ss, Ss, Iwr^Dr, Iwr^Dr, Iwr, Gd, Iwr^Edb, Iwr, Iwr^Dr, Iwr, Iwr, Gd, Iwr, Iwr, Iwr^Edb, Rb, Wwf, Wwf, Wwf, Xos, Xos
Xos, Xos, Ss, Wwf, Ss, Qxe, Sm, Sm, Rd, Gd, Wwf^Edb, Gll^Fdw, Rp, Rp, Rp, Gll^Fdw, Qxe, Gd, Rd, Qxe, Wwf, Ss, Ss, Ss^Edt, Xos, Xos
Xos, Xos, Ss, Sm, Sm^Edt, Qxe, Wwf, Sm, Rd, Gd^Fetd, Wwf, Wwg, Wwf, Wwf, 1 Rr^Dr, Wwg, Wwf, Gd^Fetd, Gll, Sm, Qxe, Rb^Dr, Ss, Ss, Xos, Xos
Xos, Xos, Wwf, Wwf, Wwf, Qxe, Ss, Wwf^Edt, Gll, Gll^Fdw, Qxe, Wwg, Sm, Sm, Wwf, Wwg, Wwf^Edb, Gll^Fdw, Rd, Wwf, Ss, Wwf, Wwf, Ss, Xos, Xos
Xos, Xos, Ss, Rb^Dr, Sm, Sm, Sm, Ss, Rd, Gd^Fetd, Wwf, Wwg, Wwf, Wwf, Wwg, Wwg, Wwf, Gd^Fetd, Sm, Sm, Wwf^Edt, Sm, Rb^Dr, Ss, Xos, Xos
Xos, Xos, Sm^Edt, Ss, Qxe, Wwf, Rb^Edt, Wwf, Gll, Gll^Fdw, Rb^Dr, Wwg^Edt, Rp, Rp, Rp, Wwg, Wwf, Gll^Fdw, Gd, Ss, Sm, Rb, Sm, Ss, Xos, Xos
Xos, Xos, Ss, Ss, Ss, Sm, Ss, Ss, Rd, Gd, Wwf, Wwg, Rp, Urb, Rp, Qxe, Qxe, Rd^Edt, Sm, Ss, Ss, Ss^Edt, Ss, Ss, Xos, Xos
Xos, Xos, Xos, Xos, Xos, Xos, Xos, Xos, Xos, Xos, Xos, Xos, Rp, Urb, Rp, Xos, Xos, Xos, Xos, Xos, Xos, Xos, Xos, Xos, Xos, Xos
Xos, Xos, Xos, Xos, Xos, Xos, Xos, Xos, Xos, Xos, Xos, Xos, Rp, Urb, Rp, Xos, Xos, Xos, Xos, Xos, Xos, Xos, Xos, Xos, Xos, Xos
