border_size=1
usage=map

Rd, Rd, Rd, Dd, Hd, Hd, Hd, Dd, Hhd, Dd^Edpp, Hhd, Hhd, Dd^Ftd, Md, Dd^Ftd, Hd, Hd, Dd^Ftd, Dd^Ftd, Dd, Dd, Dd^Ftd, Hd, Dd, Dd, Dd, Dd, Dd^Ftd, Dd, Dd, Rd, Dd, Hd, Dd, Hhd, Dd, Hd
Dd, Rd, Rd, Rd, Rd, Dd^Ftd, Md, Md, Hd, Md, Hd, Md, Hd, Hhd, Dd^Ftd, Hd, Md, Hhd, Cdr, Dd^Ftd, Hd, Rd, Dd^Ftd, Hhd, Hd, Hhd, Dd, Hhd, Md, Dd, Dd, Rd, Hhd, Hhd, Rd, Dd, Dd
Dd^Edpp, Hd, Hhd, Rd, Hhd, Rd, Rd, Rd, Dd^Ftd, Dd^Ftd, Hd, Hhd, Hhd, Hhd^Vhhr, Md, Md, Md, Hhd^Vhhr, Hhd, Hd, Hd^Edpp, Hd, Dd^Ftd, Hd, Dd^Ftd, Hhd, Hd^Edpp, Dd^Ftd, Md, Hhd, Hhd, Hhd, Dd^Ftd, Dd, Dd, Dd, Dd
Dd^Ftd, Dd^Ftd, Md, Dd^Edpp, Hd, Dd, Dd, Rd, Rd, Dd^Ftd, Hhd, Hd, Cdr, Md, Md, Md, Md, Md, Hhd, Hd, Hd, Hd, Dd^Ftd, Hhd, Hd^Edpp, Hhd, Hd, Rd, Hhd, Hhd, Md, Dd, Dd^Ftd, Dd, Hhd, Dd^Ftd, Dd
Rd, Hhd, Hhd, Md, Hhd, Dd, Hhd, Dd^Vda, Rd, Md, Rd, Rd, Cdr, 2 Kdr, Cdr, Md, Cdr, Md, Hhd, Hhd, Dd^Ftd, Dd^Vda, Dd^Ftd, Md, Hd, Md, Hd^Edpp, Hd, Hhd, Dd, Hhd, Hhd, Hhd, Hd, Hhd, Hhd, Hd
Dd, Hd, Dd^Ftd, Hd, Hhd^Vhhr, Md, Hd, Dd^Ftd, Dd^Ftd, Rd, Rd, Md, Md, Cdr, Rd, Cdr, Hd, Cdr, Dd^Ftd, Hd^Edpp, Hd, Dd^Ftd, Hhd, Md, Hhd, Dd, Hd, Hd, Md, Md, Hd, Md, Dd^Ftd, Dd^Ftd, Dd, Dd, Dd
Dd^Ftd, Dd, Hd, Hd, Hhd, Md, Rd, Hd, Dd^Vda, Hd, Md, Rd, Rd, Hd, Hd, Dd^Vda, Hd, Hd^Edpp, Dd, Dd^Ftd, Dd^Vda, Hhd, Dd, Hd, Hhd, Md, Hd, Hhd, Hhd, Hd, Dd, Dd^Ftd, Hhd, Hhd, Hhd, Hd, Dd
Dd, Hhd, Hd, Dd^Edpp, Hd, Dd, Cdr, Hhd, Md, Md, Md, Cdr, Rd, Rd, Rd, Hd^Edpp, Dd, Hd, Hhd, Dd, Rd, Hhd, Hd^Edpp, Dd^Edpp, Hhd, Hhd, Hhd, Rd, Hd, Md, Md, Dd, Hd, Hhd, Hd, Dd, Dd
Dd, Hd, Hd, Hd, Dd^Ftd, Hd, Hhd, Hhd, Hd, Cdr, Md, Rd, Hd, Hd, Rd, Rd, Dd, Dd^Ftd, Hd, Rd, Dd, Hd^Edpp, Hd, Hhd, Dd^Edpp, Hd, Dd^Ftd, Hhd, Hhd, Dd, Rd, Hhd, Hd, Hhd, Dd, Dd, Hd
Dd, Hd, Hhd, Hd, Hhd, Md, Dd^Ftd, Rd, Dd^Ftd, Hd, Hd, Hd, Dd^Ftd, Dd^Edpp, Rd, Rd, Rd, Hd, Hd, Hd^Edpp, Dd, Hd, Dd, Hd, Hd, Hd, Hhd, Hd, Dd, Md, Hhd, Hhd, Dd^Ftd, Hd, Hd, Dd^Ftd, Hd
Dd, Dd^Ftd, Rd, Rd, Dd^Ftd, Dd, Rd, Dd^Ftd, Dd^Ftd, Hd, Dd, Dd, Dd, Dd, Ds, Rd, Rd, Dd, Rd, Hd, Dd, Dd, Hd^Edpp, Hd, Dd, Hd, Dd^Ftd, Dd^Ftd, Dd^Ftd, Dd, Rd, Hhd, Rd, Dd^Ftd, Hhd, Hhd, Hd
Md, Rd, Dd^Ftd, Md, Dd^Ftd, Dd, Rd, Dd, Dd, Dd, Rd, Rd, Rd^Edpp, Dd, Dd, Dd, Rd, Rd, Dd, Dd, Dd, Ds, Rd, Dd, Dd, Hd, Rd, Hhd, Rd, Hhd, Hhd, Md, Md, Dd^Ftd, Hhd, Hd, Hd
Rd, Hd, Md, Dd^Ftd, Hhd, Md, Md, Md, Md, Dd, Dd, Ds, Ds, Dd, Rd, Dd, Rd, Rd, Dd, Rd, Dd, Rd, Rd, Dd, Rd, Dd^Ftd, Dd^Ftd, Hhd, Hhd, Hhd, Md, Hd, Dd^Ftd, Dd, Rd, Hhd, Hd
Rd, Hhd, Hhd, Hhd, Dd^Ftd, Rd, Hhd, Md, Md, Md, Hd, Dd, Ds, Dd^Edpp, Dd, Dd, Rd, Rd, Dd, Dd^Edpp, Dd, Dd, Dd, Dd^Ftd, Rd, Dd, Hhd, Hhd, Md, Hhd, Hd, Rd, Hhd, Dd^Ftd, Hd, Hhd, Hd
Dd^Ftd, Hhd, Hd, Hd, Md, Hd, Hd, Hhd, Rd, Rd, Dd^Ftd, Dd, Dd, Dd, Dd, Dd, Rd, Rd, Dd, Dd, Dd^Edpp, Ds, Dd, Dd, Dd, Dd^Ftd, Md, Hhd, Dd, Hhd, Hhd, Hhd, Hhd, Hhd, Hd, Hd, Hd
Rd, Hhd, Dd^Ftd, Md, Hhd, Md, Hhd, Hhd, Hhd, Md, Dd, Dd, Dd, Dd, Ds, Dd, Rd, Rd, Dd, Rd, Dd, Ds, Dd, Md, Dd, Dd, Hd, Dd^Ftd, Dd^Ftd, Hhd, Hhd, Hhd, Md, Hd, Dd^Ftd, Hd, Hd
Rd, Hhd, Hd, Dd^Ftd, Dd^Ftd, Hhd, Md, Md, Md, Md, Md, Md, Dd, Dd^Edpp, Dd, Dd, Dd, Rd, Rd, Dd, Dd, Ds^Edpp, Dd, Md, Dd, Dd^Ftd, Hd, Dd, Md, Md, Hd, Md, Md, Rd, Hd, Rd, Hd
Rd, Hd, Md, Dd^Ftd, Rd, Hhd, Hhd, Hd, Hd, Hhd, Rd, Dd, Dd^Ftd, Dd, Ds^Edpp, Ds, Dd, Rd, Rd, Dd, Dd, Dd, Dd, Dd, Md, Dd, Dd, Hhd, Hd, Rd, Hd, Md, Dd^Ftd, Hhd, Hd, Rd, Hd
Md, Hhd, Hhd, Dd^Ftd, Md, Md, Hd, Md, Hhd, Hd, Md, Dd, Dd, Ds, Ds, Ds, Dd, Rd, Rd, Dd, Ds^Edpp, Dd, Dd, Hhd, Dd, Dd, Hhd, Md, Md, Hhd, Dd^Ftd, Hd, Rd, Hd, Hd, Rd, Hd
Rd, Md, Rd, Md, Hhd, Md, Md, Hhd, Dd, Dd, Dd^Ftd, Dd^Ftd, Dd, Dd, Dd, Dd^Edpp, Dd^Edpp, Rd, Rd, Dd, Dd, Dd, Dd^Edpp, Hhd^Edpp, Dd, Dd^Ftd, Dd, Md, Dd^Ftd, Hhd, Rd, Rd, Hhd, Dd^Ftd, Hhd, Hhd, Hd
Md, Md, Md, Dd^Ftd, Hhd, Hhd, Rd, Rd, Hhd, Dd, Md, Dd, Dd, Ds, Dd^Edpp, Dd, Dd, Rd, Rd, Dd, Dd, Dd^Edpp, Dd, Dd, Hhd, Dd^Ftd, Dd, Hhd, Hd, Md, Dd^Ftd, Hd, Hd, Hhd, Hd, Hd, Hd
Hhd, Hhd, Dd^Ftd, Hhd, Hhd, Dd^Ftd, Md, Dd^Ftd, Md, Rd, Hhd, Hhd, Dd, Ds, Dd^Edpp, Dd, Dd, Rd, Rd, Dd, Dd, Ds, Dd, Dd, Dd, Md, Md, Md, Hhd, Hhd, Hd, Hhd, Hhd, Hhd, Rd, Hd, Hd
Hhd, Hhd, Hd, Hd, Rd, Md, Dd^Ftd, Rd, Md, Rd, Md, Dd, Dd, Ds, Dd, Ds, Dd, Dd, Rd, Dd, Dd, Ds, Dd^Edpp, Dd, Dd, Dd^Ftd, Dd, Hhd, Rd, Hd, Md, Hhd, Hd, Dd^Ftd, Hd, Rd, Hd
Md, Md, Rd, Hd, Hhd, Md, Md, Md, Md, Rd, Hhd, Dd, Hhd, Dd, Dd, Dd^Edpp, Dd, Dd, Rd, Dd, Dd, Ds, Ds, Dd, Dd^Ftd, Dd^Ftd, Dd, Hhd, Md, Dd^Ftd, Hd, Md, Hd, Rd, Dd^Ftd, Hhd, Dd
Hhd, Md, Dd^Ftd, Hhd, Dd, Dd^Ftd, Dd^Ftd, Md, Rd, Md, Dd, Dd^Ftd, Dd, Dd^Ftd, Dd^Edpp, Dd, Dd, Rd, Rd, Dd, Dd, Hhd, Dd, Dd, Hd, Hhd, Hhd, Dd, Md, Dd^Ftd, Dd^Ftd, Hhd, Hhd, Hhd, Hd, Hhd, Hhd
Hd, Rd, Md, Hhd, Hd, Hhd, Md, Hd, Hhd, Dd^Ftd, Dd, Dd^Ftd, Dd, Dd, Dd, Dd, Dd, Dd, Rd, Dd, Dd, Hhd, Dd, Dd, Hd, Dd^Ftd, Dd, Md, Hhd, Hd, Md, Md, Hhd, Rd, Hhd, Hhd, Hhd
Dd, Dd^Ftd, Dd^Ftd, Hhd, Hd, Hd, Hhd, Hd, Md, Hd, Hhd, Hhd, Hhd, Dd, Dd, Ds, Dd, Rd, Rd, Dd, Dd, Dd, Dd, Dd, Md, Dd, Dd^Ftd, Hhd, Hd, Hhd, Hhd, Hhd, Dd^Ftd, Dd^Ftd, Md, Hd, Hd
Dd, Hhd, Hd, Md, Hd, Rd, Hd, Md, Hhd, Md, Hd, Md, Dd, Dd, Dd^Edpp, Ds, Dd, Rd, Rd, Dd, Dd^Edpp, Ds, Dd, Dd, Dd, Dd, Hd, Dd^Ftd, Rd, Dd^Ftd, Md, Hd, Hd, Hhd, Md, Hd, Hhd
Md, Hhd, Hhd, Hhd, Hd, Dd^Ftd, Hd, Hhd, Hhd, Dd^Ftd, Dd, Dd, Dd^Edpp, Dd, Ds, Dd, Dd, Rd, Dd, Dd, Dd, Ds, Dd, Dd, Dd, Md, Hhd, Hhd, Md, Dd, Md, Hd, Md, Hhd, Hd, Hhd, Hd
Hhd, Md, Md, Rd, Hd, Dd^Ftd, Dd, Dd^Ftd, Hd, Hhd, Hhd, Dd, Dd^Edpp, Dd, Dd, Dd, Dd^Ftd, Rd, Rd, Dd, Dd, Ds, Ds^Edpp, Dd, Dd, Dd, Dd, Md, Hd, Md, Md, Hhd, Md, Hd, Rd, Hd, Hhd
Hhd, Dd^Ftd, Md, Hd, Dd^Ftd, Hhd, Md, Md, Dd^Ftd, Rd, Rd, Md, Hhd, Dd, Dd, Ds, Dd, Rd, Rd, Dd, Dd, Dd^Edpp, Dd, Dd^Ftd, Dd, Dd^Ftd, Dd, Dd^Ftd, Hd, Hd, Md, Md, Hd, Md, Dd^Ftd, Hd, Md
Hhd, Md, Md, Hhd, Hd, Hd, Hd, Hd, Hhd, Rd, Hhd, Dd, Dd, Dd, Dd^Edpp, Dd^Edpp, Dd, Dd, Rd, Dd, Dd, Dd, Dd, Dd, Dd, Dd^Ftd, Dd^Ftd, Dd^Ftd, Hhd, Md, Md, Hd, Md, Hhd, Hd, Md, Hhd
Rd, Hhd, Hhd, Hhd, Rd, Hhd, Hhd, Hd, Hhd, Dd^Ftd, Md, Dd, Dd^Ftd, Dd^Ftd, Hd, Dd, Dd, Rd, Rd, Dd, Dd, Hhd, Dd, Dd, Md, Dd, Md, Dd^Ftd, Hhd, Hd, Hd, Hhd, Hhd, Hd, Hd, Md, Hd
Hd, Dd^Ftd, Rd, Hhd, Md, Hhd, Hhd, Md, Md, Hhd, Hhd, Hd, Hd, Rd, Hd, Dd, Hhd, Rd, Rd, Hd, Rd, Dd, Hhd, Dd, Dd, Dd, Md, Hhd, Hhd, Md, Md, Md, Hd, Rd, Dd^Ftd, Hd, Hhd
Hd, Hd, Md, Md, Dd^Ftd, Dd^Ftd, Rd, Md, Md, Hhd, Hhd, Md, Md, Hd, Hd, Ds^Edpp, Dd, Rd, Rd, Rd, Hd, Ds, Dd, Rd, Dd^Ftd, Rd, Dd, Dd, Rd, Hhd, Md, Hhd, Md, Dd^Ftd, Hd, Hd, Hd
Hhd, Hhd, Dd^Ftd, Dd^Ftd, Rd, Rd, Md, Hhd, Md, Hd, Hhd, Rd, Hd, Ds^Edpp, Hd, Hhd, Dd, Rd, Rd, Dd, Hhd, Hhd, Dd, Hd, Rd, Dd, Hhd, Hhd, Hhd, Dd^Ftd, Rd, Dd^Ftd, Rd, Hhd, Hd, Hhd, Hhd
Dd, Hd, Hd, Rd, Md, Hd, Hhd, Md, Hhd, Dd^Edpp, Dd^Ftd, Hhd, Hd, Hhd, Dd, Hd, Dd, Rd, Rd, Dd, Ds, Hhd, Rd, Dd, Dd^Ftd, Dd, Dd, Hhd, Dd^Ftd, Hhd, Hhd, Hd, Md, Md, Hd, Hhd, Hd
Md, Md, Md, Hd, Md, Hd, Rd, Hhd, Hhd, Hhd, Dd^Ftd, Hd, Rd, Hd, Hd, Hd, Cdr, Cdr, Cdr, Hhd, Dd, Ds, Hhd, Hd, Dd, Md, Hhd, Dd^Ftd, Md, Md, Hhd, Hhd, Md, Md, Rd, Hd, Hd
Dd^Ftd, Hhd, Hhd, Dd^Ftd, Md, Md, Md, Md, Rd, Md, Dd^Ftd, Hd, Dd^Ftd, Dd, Hhd, Rd, Hd, Rd, Rd, Hhd, Hd, Dd, Hhd, Dd, Dd^Ftd, Md, Dd^Ftd, Hhd, Hhd, Md, Hd, Hhd, Md, Hd, Hd, Dd^Ftd, Hd
Hd, Dd^Ftd, Hhd, Dd^Ftd, Md, Hhd, Hd, Dd^Ftd, Rd, Dd, Hhd, Hhd, Cdr, Hhd, Cdr, Rd, Rd, Rd, Hd, Dd, Hd, Hhd, Hhd, Hhd, Dd, Dd^Ftd, Dd^Ftd, Dd^Ftd, Rd, Hd, Hhd, Hhd, Md, Md, Hd, Hd, Hhd
Hd, Hd, Md, Hhd, Md, Dd^Ftd, Hd, Rd, Hd, Md, Hd, Md, Md, Hhd, Hd, Hd, Hd, Rd, Rd, Hd, Hd, Cdr, Hhd, Dd, Dd^Ftd, Md, Hhd, Md, Rd, Hd, Hd, Md, Md, Hhd, Hhd, Dd^Ftd, Hd
Md, Md, Md, Md, Md, Md, Hhd, Md, Md, Md, Dd^Ftd, Dd, Hhd, Hd, Dd, Dd, Dd, Rd, Rd, Hhd, Hd, Hhd, Hd, Dd^Ftd, Dd^Ftd, Hhd, Md, Hd, Hhd, Rd, Hhd, Hhd, Hd, Hd, Hhd, Dd, Hd
Hd, Hd, Dd^Ftd, Dd^Ftd, Dd^Ftd, Hhd, Md, Hd, Md, Dd^Ftd, Hhd, Dd^Ftd, Hhd, Hhd, Md, Cdr, Cdr, Rd, Cdr, Md, Md, Md, Hhd, Hhd, Md, Dd, Hhd, Hhd, Dd^Ftd, Dd^Ftd, Rd, Rd, Dd^Ftd, Hd, Hhd, Hhd, Hd
Dd^Ftd, Dd^Ftd, Rd, Hd, Hhd, Dd^Ftd, Md, Md, Hhd, Hhd, Hhd, Dd, Md, Cdr, Hd, Cdr, Cdr, 3 Kdr, Cdr, Cdr, Md, Md, Md, Hd, Rd, Hhd, Hhd, Rd, Hd, Hhd, Rd, Dd^Ftd, Hd, Hhd, Hhd, Md, Hd
Md, Md, Md, Hd, Hhd, Hd, Md, Md, Md, Hd, Hhd, Dd, Hd, Hd, Hd, Hhd, Hhd, Rd, Dd, Cdr, Rd, Md, Hd, Dd^Ftd, Dd^Ftd, Rd, Hd, Md, Hd, Hhd, Md, Md, Hd, Hhd, Rd, Hd, Rd
Hd, Hd, Dd^Ftd, Hhd, Hd, Dd^Ftd, Hd, Md, Hhd, Rd, Hhd, Hd, Dd^Ftd, Md, Md, Hd, Rd, Rd, Md, Dd, Md, Hhd, Cdr, Dd, Hd, Hd, Hhd, Md, Dd^Ftd, Md, Md, Md, Md, Hd, Hhd, Hhd, Hhd
Hd, Dd^Ftd, Hhd, Rd, Hhd, Md, Md, Hhd, Rd, Hd, Dd^Ftd, Hd, Cdr, Cdr, Hd, Rd, Hd, Ds, Hhd, Hhd, Md, Hhd, Hd, Hd, Md, Hd, Dd^Ftd, Hd, Hhd, Hhd, Hd, Md, Hhd, Hhd, Hd, Dd^Ftd, Hd
Md, Md, Hhd, Dd^Ftd, Dd^Ftd, Hhd, Hhd, Rd, Dd^Ftd, Hhd, Hhd, Hd, Hhd, Hd, Hd, Hhd, Dd, Rd, Dd, Hd, Hhd, Cdr, Hd, Hhd, Hd, Dd^Ftd, Hhd, Hhd, Rd, Hhd, Rd, Hhd, Hd, Hd, Dd^Ftd, Hd, Hhd
Hd, Hhd, Dd^Ftd, Md, Md, Hhd, Dd^Ftd, Hhd, Md, Hhd, Md, Dd^Ftd, Dd^Ftd, Hhd, Rd, Hd, Dd, Rd, Hhd, Hd, Hhd, Dd, Hhd, Hd, Md, Hhd, Hhd, Md, Dd^Ftd, Dd^Ftd, Hhd, Hhd, Hhd, Rd, Hhd, Hhd, Hd
Hd, Hd, Dd^Ftd, Hd, Dd^Ftd, Dd^Ftd, Hhd, Md, Dd^Ftd, Hd, Hhd, Hhd, Dd, Hhd, Cdr, Hhd, Rd, Rd, Dd, Hhd, Cdr, Hhd, Dd, Hd, Hd, Hhd, Hd, Hd, Hd, Md, Md, Hhd, Hhd, Dd^Ftd, Dd^Ftd, Hd, Hd
Hd, Md, Rd, Rd, Hd, Md, Md, Hd, Hhd, Dd, Hhd, Rd, Dd, Rd, Rd, Dd, Dd, Rd^Edpp, Dd, Rd, Rd, Dd, Rd, Rd, Hd, Dd^Ftd, Hd, Hhd, Md, Hhd, Hd, Hd, Hd, Rd, Dd^Ftd, Hd, Hd
Md, Md, Dd^Ftd, Hhd, Rd, Hd, Md, Hd, Hd, Hhd, Dd, Dd, Dd^Edpp, Ds, Dd^Edpp, Rd, Cdr, Rd, Cdr, Rd, Dd, Ds, Dd, Hd, Hhd, Hhd, Md, Dd^Ftd, Hhd, Rd, Hhd, Hhd, Hd, Hhd, Hhd, Hhd, Hd
Dd^Ftd, Dd^Ftd, Md, Dd^Ftd, Hd, Dd^Ftd, Dd^Ftd, Hd, Hd, Md, Dd, Dd, Ds, Dd, Rd, Dd, Dd, Cdr, Dd, Dd, Ds^Edpp, Rd, Dd, Hd, Hd, Md, Hhd, Hhd, Md, Hhd, Rd, Dd^Ftd, Md, Hhd, Md, Hhd, Hd
Md, Hd, Md, Hhd, Md, Rd, Hd, Hhd, Hd, Dd^Ftd, Dd^Ftd, Dd, Dd, Dd, Dd, Dd, Rd, Rd, Dd, Dd, Rd, Dd, Dd, Hd, Md, Md, Hd, Hhd, Hhd, Dd^Ftd, Dd^Ftd, Hhd, Hhd, Md, Hd, Hd, Hd
Md, Md, Md, Md, Dd^Ftd, Hhd, Rd, Hd, Dd^Ftd, Dd, Dd, Dd, Dd^Edpp, Dd^Ftd, Dd, Dd, Rd, Rd, Dd, Rd, Rd, Dd, Hd, Hd, Hd, Md, Md, Md, Rd, Hd, Hhd, Dd^Ftd, Rd, Hhd, Hd, Md, Hhd
Hd, Dd^Ftd, Dd^Ftd, Hhd, Hhd, Hhd, Dd^Ftd, Md, Dd^Ftd, Hhd, Dd^Ftd, Dd, Dd, Dd, Dd^Edpp, Rd, Dd, Rd, Dd^Edpp, Dd, Ds, Hd, Hhd, Dd^Ftd, Hhd, Hhd, Hhd, Hhd, Rd, Dd^Ftd, Hd, Hd, Hd, Md, Hd, Hd, Md
Hhd, Hd, Hd, Hd, Md, Rd, Md, Rd, Dd, Dd, Dd, Dd, Dd, Ds, Dd, Rd, Dd, Rd, Dd, Dd^Edpp, Dd, Hd, Hd, Hd, Md, Hhd, Md, Dd^Ftd, Md, Hhd, Hd, Dd^Ftd, Hhd, Dd^Ftd, Hhd, Md, Dd
Md, Md, Dd^Ftd, Hhd, Hhd, Hhd, Hd, Md, Md, Md, Ds, Dd, Dd, Dd^Edpp, Dd, Dd, Rd, Rd, Dd, Ds, Dd, Hd, Hd, Md, Hd, Hd, Hhd, Hd, Md, Md, Md, Hhd, Hd, Hd, Hd, Hd, Hd
Hhd, Md, Hhd, Rd, Hhd, Md, Dd^Ftd, Md, Hhd, Hhd, Dd, Dd, Dd^Edpp, Dd, Dd, Rd, Rd, Rd, Dd^Edpp, Dd, Dd^Edpp, Dd, Dd, Hd, Dd, Dd^Ftd, Md, Md, Hhd, Hd, Hd, Md, Hd, Dd^Ftd, Hhd, Hhd, Hhd
Hhd, Hhd, Md, Md, Md, Dd, Hd, Md, Rd, Md, Dd, Ds, Dd^Edpp, Dd, Dd, Dd^Edpp, Dd, Rd, Rd, Dd^Edpp, Ds, Dd^Edpp, Dd^Edpp, Dd, Md, Hhd, Md, Hd, Hd, Md, Hhd, Hd, Md, Rd, Rd, Hhd, Hd
Rd, Md, Md, Md, Dd^Ftd, Md, Md, Rd, Hd, Hd, Dd^Ftd, Dd^Ftd, Dd^Edpp, Ds, Dd, Dd, Rd, Rd, Dd, Dd, Rd, Dd, Dd, Dd, Hhd, Md, Hd, Rd, Rd, Hd, Md, Hhd, Hd, Rd, Hd, Hhd, Dd
Rd, Hd, Hd, Hhd, Md, Hhd, Hhd, Md, Hhd, Hd, Dd, Dd, Dd^Ftd, Dd^Edpp, Ds^Edpp, Dd, Rd, Rd, Dd, Dd, Rd, Dd, Dd, Dd, Hd, Hd, Hd, Dd^Ftd, Rd, Hhd, Hd, Hhd, Dd^Ftd, Hhd, Hd, Dd^Ftd, Dd
Rd, Dd^Ftd, Hd, Hhd, Md, Hhd, Hd, Md, Md, Hd, Md, Dd, Dd^Ftd, Dd, Dd^Edpp, Rd, Dd, Rd, Rd, Dd, Ds^Edpp, Dd, Dd, Hd, Hd, Md, Hd, Rd, Md, Md, Hhd, Hd, Rd, Hhd, Hhd, Hhd, Dd
Hhd, Dd^Ftd, Md, Md, Md, Md, Hhd, Md, Dd^Ftd, Hd, Dd, Dd, Ds, Dd, Ds, Ds, Rd, Rd, Dd, Dd, Dd, Dd, Hd, Dd, Hd, Hd, Hhd, Dd^Ftd, Hd, Md, Hd, Hhd, Dd^Ftd, Hhd, Rd, Hhd, Dd
Hd, Hhd, Md, Hhd, Md, Rd, Md, Hhd, Md, Dd, Hhd, Dd, Ds, Dd^Edpp, Dd, Dd, Rd, Rd, Dd, Dd, Hd, Hd, Md, Hd, Hhd, Hd, Md, Rd, Hhd, Hhd, Dd^Ftd, Hhd, Md, Hd, Md, Hhd, Dd
Rd, Rd, Hhd, Hd, Dd^Ftd, Md, Hd, Hd, Hhd, Hd, Md, Hd, Dd, Dd, Dd^Edpp, Rd, Dd, Rd, Rd, Dd, Hd, Md, Hd, Dd^Ftd, Dd^Ftd, Hd, Dd^Ftd, Hhd, Hd, Md, Hhd, Rd, Dd^Ftd, Hd, Hd, Hhd, Hhd
Hhd, Md, Hd, Hhd, Hd, Dd^Ftd, Hd, Hhd, Hd, Dd^Ftd, Hd, Hd, Hhd, Dd, Ds, Dd, Dd^Edpp, Rd, Dd, Dd, Dd, Hd, Hhd, Md, Hhd, Hd, Hhd, Hd, Md, Hhd, Hd, Md, Dd^Ftd, Md, Md, Hd, Dd
Dd^Ftd, Dd^Ftd, Hd, Dd^Ftd, Md, Md, Hhd, Hhd, Hd, Hd, Md, Hd, Dd, Dd^Edpp, Ds, Dd, Rd, Rd, Rd, Dd, Dd^Edpp, Dd, Ds, Hd, Hd, Md, Hd, Hd, Hhd, Hd, Hd, Hhd, Hhd, Md, Md, Md, Md
Rd, Md, Md, Hhd, Hhd, Dd^Ftd, Md, Hhd, Md, Dd^Ftd, Hd, Hd, Dd, Dd, Dd, Dd^Edpp, Dd, Rd, Rd, Dd, Dd^Edpp, Dd, Dd, Dd, Dd, Md, Hhd, Hhd, Hhd, Md, Dd^Ftd, Hd, Md, Hd, Hhd, Hhd, Dd
Rd, Hd, Dd^Ftd, Md, Md, Hhd, Hhd, Md, Md, Hd, Hd, Dd, Dd^Ftd, Dd, Dd, Ds, Rd, Rd, Dd, Dd, Ds^Edpp, Dd, Dd, Dd, Dd, Hhd, Gd^Fts, Hd, Hd, Hhd, Hd, Hd, Hd, Dd^Ftd, Hd, Hhd, Dd
Hhd, Hhd, Md, Hhd, Hd, Hhd, Dd^Ftd, Hhd, Md, Md, Dd, Dd, Dd, Dd^Edpp, Ds, Rd, Dd, Rd, Rd, Ds^Edpp, Dd^Edpp, Dd, Rd, Dd, Hhd, Md, Hhd, Hhd, Hd, Hhd, Md, Hd, Hhd, Hd, Hhd, Hhd, Hhd
Md, Rd, Rd, Rd, Hd, Hhd, Hhd, Hhd, Hd, Hd, Hd, Dd^Ftd, Dd, Ds, Ds, Dd, Dd, Rd, Rd, Dd, Rd, Dd, Dd, Dd, Hhd, Hhd, Gd^Fts, Hhd, Hd, Md, Md, Md, Md, Hhd, Md, Hd, Hd
Hhd, Dd^Ftd, Md, Md, Md, Hd, Md, Hhd, Hd, Md, Md, Hd, Dd, Dd^Edpp, Dd, Dd, Rd, Rd, Dd, Dd, Dd, Dd, Dd^Edpp, Dd, Dd, Hhd, Hd, Hd, Hd, Gd^Fts, Hd, Md, Hhd, Gd^Fts, Hd, Hd, Hd
Md, Dd^Ftd, Hhd, Md, Hhd, Md, Rd, Dd^Ftd, Hhd, Hd, Md, Hd, Dd, Dd, Dd^Edpp, Dd, Ce, Ce, Ce, Dd, Ds^Edpp, Dd, Ds, Dd, Hhd, Dd, Hhd, Hd, Md, Md, Gd^Fts, Hd, Hhd, Hd, Hd, Md, Hd
Hd, Rd, Dd^Ftd, Md, Md, Md, Rd, Hhd, Md, Hhd, Md, Hd, Dd, Dd, Dd, Dd^Vdt, Ce, 1 Ke, Ce, Dd^Vdt, Ds, Dd^Edpp, Dd, Hhd, Dd, Hhd, Md, Hhd, Hhd, Md, Hhd, Hd, Md, Md, Md, Hd, Hhd
Md, Md, Rd, Hhd, Hd, Md, Md, Dd^Ftd, Md, Hhd, Md, Hhd, Hhd, Ds^Edpp, Dd, Dd, Dd, Ce, Dd, Dd, Dd, Dd, Hhd, Dd, Hd, Hhd, Hhd, Hd, Hd, Md, Rd, Md, Hd, Md, Md, Md, Dd
Md, Md, Dd, Dd^Ftd, Md, Dd^Ftd, Md, Md, Hhd, Hhd, Dd, Hd, Hhd, Dd, Dd, Dd, Dd, Dd, Dd, Dd, Dd, Hhd, Dd, Hhd, Hhd, Hd, Hhd, Hd, Hhd, Hd, Hhd, Hd, Hd, Hhd, Hhd, Hhd, Dd
