border_size=1
usage=map

Xos, Xos, Xos, Xos, Xos, Xos, Xos, Xos, Xos, Xos, Xos, Xos, Xos
Xos, Xos, Xos, Xos, Xos, Xos, Xos, Xos, Xos, Xos, Xos, Xos, Xos
Xos, Xos, Ww^Ewf, Ww^Ewf, Ww, Wwf, Ch, Iwr, Iwr, Iwr, Iwr, Xos, Xos
Xos, Xos, Ww, Ww, Wwf^Bw\, Wwf, Ch, Iwr, Iwr, Iwr, Iwr, Xos, Xos
Xos, Xos, Wwf, Wwf, Ch, Ch, Iwr, Iwr, Iwr, Iwr, Iwr, Xos, Xos
Xos, Xos, Ch, Ch, Iwr, Iwr, Iwr, Iwr, Ch, Ch, Ch, Xos, Xos
Xos, Xos, Iwr, Iwr, Iwr, Iwr, Iwr, Ch, Gs^Efm, Gs^Fms, Gs^Fds, Xos, Xos
Xos, Xos, Iwr, Iwr, Iwr, Iwr, Iwr, Ch, Gg^Efm, Gg^Fet, Gg^Efm, Xos, Xos
Xos, Xos, Iwr, Iwr, Iwr, Iwr, Iwr, Ch, Ch, Gs^Fds, Ch, Xos, Xos
Xos, Xos, Iwr, Iwr, Iwr, Iwr, Iwr, Iwr, Iwr, Ch, Iwr, Xos, Xos
Xos, Xos, Iwr, Iwr, Iwr, Iwr, Rr, Iwr, Iwr, Iwr, Iwr, Xos, Xos
Xos, Xos, Xos, Xos, Xos, Xos, Rr, Xos, Xos, Xos, Xos, Xos, Xos
Xos, Xos, Xos, Xos, Xos, Xos, Rr, Xos, Xos, Xos, Xos, Xos, Xos
