Xu, Xu, Xu, Xu, Xu, Xu, Xu, Xu, Xu, Urb, Ur, Uh, Ur, Urb, Xu, Xu, Xu, Xu, Xu, Xu, Xu, Xu
Xu, Qxe, Qlf, Qlf, Uu, Uu, Uue, Uh, Uh, Urb, Ur, Uh, Ur, Urb, Qlf, Uh, Uh, Uh, Uh, Qlf, Qlf, Xu
Xu, Uue, Uu, Uue, Uue, Qlf, Uu^Ii, Uu, Uue, Urb, Urb, Ur, Urb, Urb, Uu^Ii, Qlf, Uu, Qxe, Uh, Uue, Qxe, Xu
Xu, Uu, Uh, Uu, Uue, Uu, Ql, Uu, Cud, Uue, Cud, Kud, Cud, Uu, Cud, Uue, Ql, Uue, Uu, Uue, Uu, Xu
Xu, Uue, Qlf, Uh, Qlf, Qlf, Ql, Cud, Ql, Cud, Ur, Ur, Ur, Cud, Ql, Cud, Ql, Qlf, Uu, Uu^Ii, Uue, Xu
Xu, Qlf, Uu, Uh, Qlf, Qxe, Uue, Ql, Uue, Ql, Urb, Ur, Urb, Ql, Uue, Ql, Uue, Qlf, Qlf, Uue, Uh, Xu
Xu, Qlf, Uue, Qlf, Uu, Uu^Ii, Uu, Uu, Qlf, Uu, Urb, Ur, Urb, Uu, Uue, Qxe, Uu, Uue, Uh, Qlf, Qlf, Xu
Xu, Uue, Qxe, Uu, Urb, Uue, Urb, Urb, Urb, Uue, Urb, Ur, Urb, Uu^Ii, Urb, Urb, Urb, Qlf, Urb, Qlf, Uue, Xu
Xu, Qlf, Uue, Urb, Ur, Urb, Ur, Ur, Ur, Urb, Urb, Ur, Urb, Urb, Ur, Ur, Ur, Urb, Ur, Urb, Uh, Xu
Xu, Uue, Uue, Urb, Cud, Ur, Urb, Cud, Urb, Ur, Ur, Cud, Ur, Ur, Urb, Cud, Urb, Ur, Cud, Urb, Uue, Xu
Xu, Uh, Uh, Uu, Urb, Ur, Urb, Uu, Uue, Urb, Urb, Ur, Urb, Urb, Uu, Uue, Urb, Ur, Urb, Uu, Uh, Xu
Xu, Qxe, Qxe, Uue, Uu, Urb, Uue, Uu, Qxe, Qxe, Urb, Ur, Urb, Uue, Uh, Qxe, Uue, Urb, Uu, Uue, Qxe, Xu
Xu, Xu, Xu, Xu, Xu, Xu, Xu, Xu, Xu, Uu, Urb, Ur, Urb, Qxe, Xu, Xu, Xu, Xu, Xu, Xu, Xu, Xu
