border_size=1
usage=map

Wo, Wo, Wo, Ww, Wwf, Ww, Ww, Ww, Ww, Ww, Wo, Wwf, Wwf, Ww, Ww, Wo, Ww, Ww, Ww, Ww
Wo, Wo, Wo, Wo, Ww, Wwf, Wwf, Ww, Wwr, Ww, Wwf, Wwf, Wo, Ww, Ww, Wo, Wo, Ww, Ww, Wo
Ww, Ww, Wwr, Ww, Ww, Ww, Wwf, Ww, Ds, Ww, Wwf, Wwr, Ww, Wo, Ww, Ww, Ww, Ww, Ww, Wo
Ww, Wo, Ww, Wwr, Ds, Dd^Ftd, Hd, Dd^Ftd, Dd^Ftd, Wwf, Dd, Wwf, Wwf, Wwr, Wwr, Ww, Ww, Wwr, Ww, Ww
Wo, Wo, Wo, Wwr, Ww, Ds, Ds, Ds, Ds, Dd, Gd^Fts, Dd, Wwf, Ww, Wwr, Ww, Wo, Ww, Wo, Ww
Ww, Ww, Ww, Wwf, Wwf, Wwf, Wwf, Wwf, Dd^Ftd, Dd, Hd, Hd, Ds, Ds, Ds, Ww, Wwr, Wo, Ww, Wo
Wo, Ww, Wwr, Wwr, Ww, Ds, Hd, Wwf, Wwf, Dd, Dd, Gd^Fts, Dd, Gd^Fts, Hd, Ww, Ww, Ww, Ww, Ww
Wo, Wo, Ww, Wwr, Ds, Dd^Ftd, Ds, Gd^Fts, Hd, Dd, Gd^Fts, Hd, Wwf, Dd, Dd^Ftd, Wwf, Dd^Ftd, Ww, Ww, Ww
Ww, Ww, Ww, Wwr, Wwr, Ds, Wwf, Dd^Ftd, Ww, Ds, Ds, Wwf, Ww, Ds, Ww, Dd^Ftd, Ww, Ww, Wo, Wo
Ww, Wwr, Wo, Ww, Wwr, Ww, Wwf, Ds, Ww, Ww, Wwf, Ww, Ww, Ww, Wo, Ww, Ww, Wo, Wo, Ww
Wo, Wo, Wwr, Wwr, Ww, Wwf, Ww, Ww, Wwr, Wwr, Ww, Wwf, Ww, Wo, Ww, Wwr, Ww, Ww, Ww, Wo
Ww, Ww, Ww, Ww, Wo, Ww, Ww, Wwr, Ww, Wo, Ww, Ww, Wo, Wo, Ww, Wwr, Ww, Wo, Ww, Wo
Ww, Ww, Wo, Wo, Ww, Ww, Ww, Ww, Ww, Wo, Ww, Ww, Wo, Ww, Ww, Ww, Ww, Wo, Ww, Ww
